Wikipedia:Article titles	Content	(?:\bW(?:P:(?:N(?:A(?:M(?:INGCRITERIA|ECHANGES)|TURAL(?:NES|DI)S)|POV(?:TITL|NAM)E|DESC|OUN)|T(?:ITLE(?:(?:SPECIALCHARACTER|CHANGE)S|FORMAT|VAR|TM)?|RANSLITERATE|SC)|D(?:E(?:SCRIPDIS|FINITE)|IFF(?:PUNCT|CAPS))|P(?:OV(?:TITL|NAM)E|RECIS(?:ION|E)|ARENDIS)|C(?:O(?:MM(?:ONNAME|ADIS)|NCISE)|RITERIA)|(?:ITALICTITL|LOWERCAS)E|A(?:T(?:D(?:AB|IS))?|ND)|S(?:MALLDETAILS|INGULAR)|RECOGNIZABILITY|OTHERNAMES|U(?:CRN|E)|QUALIFIER|MOSAT)|ikipedia:Article titles)\b)
Wikipedia:Biographies of living persons	Content	(?:\bW(?:P:(?:B(?:LP(?:S(?:E(?:LF(?:PUB)?|EALSO)|OURCES?|TYLE|PS)|R(?:E(?:QUEST(?:RESTOR|DELET)|MOV)E|S)|C(?:O(?:MPLAINT?|I)|RIME|AT)|(?:NAM(?:EABUS)?|BALANC|1)E|P(?:RI(?:MAR|VAC)Y|UBLIC)|D(?:EL(?:ETE)?|S)|G(?:OSSI|ROU)P|KIND(?:NESS)?|E(?:DIT|L)|ADMINS|TALK|FR)?|IOSELF|DP)|(?:L(?:PNAM|IV)|PUBLICFIGUR|GRAPEVIN)E|N(?:OTPUBLICFIGURE|PF)|AVOIDVICTIM|WELLKNOWN|SUSPECT|DOB|MUG)|ikipedia:Biographies of living persons)\b)
Wikipedia:Image use policy	Content	(?:\bW(?:P:(?:I(?:UP(?:#(?:(?:COPYRIGH|FORMA)T|ANIM|NAME|RI)|C)?|M(?:AGE(?:SIZE|POL)|GSIZE)|QUEUE|G)|(?:(?:THUMB|FILE)SIZ|MONTAG)E|WATERMARK|GALLERY)|ikipedia:Image use policy)\b)
Wikipedia:Neutral point of view	Content	(?:\bW(?:P:(?:(?:S(?:UB(?:STANTIAT|JECTIV)|TRUCTUR)|FALSEBALANC|(?:UN)?DU)E|N(?:P(?:OV(?:(?:VIE|HO)W|FACT)?|V)|EUTRAL)|A(?:(?:CHIEVE N|TTRIBUTE)POV|ESTHETIC)|P(?:OV(?:NAMING)?|ROPORTION|SCI)|B(?:ALA(?:NCED?|SP)|ESTSOURCES)|W(?:IKIVOICE|EIGHT)|(?:IMPARTI|GEV)AL|(?:YES|RN)POV|TINFOILHAT|VALID|MNA)|ikipedia:Neutral point of view)\b)
Wikipedia:No original research	Content	(?:\bW(?:P:(?:S(?:YN(?:TH(?:ESIS)?)?|TICKTOSOURCE|ECONDARY)|T(?:RANSCRIPTION|ERTIARY)|O(?:R(?:IGINAL)?|I)|P(?:RIMARY|STS)|(?:VERIFY|N)OR|AEIS|CALC)|ikipedia:No original research)\b)
Wikipedia:Verifiability	Content	(?:\bW(?:P:(?:S(?:O(?:URCE(?:(?:ACCES)?S)?|CIALMEDIA)|ELFPUB(?:LISH)?|PS)|N(?:O(?:TR(?:ELIABLE|S)|N?ENG)|EWSBLOG)|R(?:E(?:D(?:FLAG|DIT)|FLOOP)|SUE)|EX(?:TRAORDINARY|CEPTIONAL)|P(?:AY(?:SITE|WALL)|ROVEIT)|C(?:IRC(?:ULAR)?|HALLENGE)|V(?:ER(?:IFY)?|NOTSUFF)?|FAILEDVERIFICATION|U(?:NSOURCED|GS)|B(?:URDEN|LOGS)|YTCOPYRIGHT|(?:ONU|Q)S|ABOUTSELF|TWITTER)|ikipedia:Verifiability)\b)
Wikipedia:What Wikipedia is not	Content	(?:\bW(?:P:(?:NO(?:T(?:C(?:O(?:MPULSORY|OKBOOK|URT)|A(?:TALOG(?:UE)?|SE)|RYSTA(?:LBAL)?L|HANGELOG|LICKBAIT|ENSORED|V)|S(?:T(?:AT(?:S(?:BOOK)?|UTE)|ORAGE|UPID)|O(?:CIAL(?:NETWORK|MEDIA)?|APBOX)|PECULATION|CANDAL)|B(?:UR(?:EAU(?:CRACY)?|O)|ATTLE(?:GROUND)?|IBLIOGRAPHY|ROCHURE|LOG)|P(?:R(?:O(?:MO(?:TION)?|PAGANDA)|ESSRELEASE)|L(?:OT|UG)|APERS?)|D(?:I(?:R(?:ECTORY)?|ARY)|EM(?:OCRACY)?|ATINGSERVICE)|R(?:E(?:(?:CIP|SUM)E|POSITORY|QUIRED)|ADIOGUIDE|UMOR)|A(?:D(?:V(?:ERTISING|OCACY|ICE)|IARY)|NARCHY)|F(?:A(?:CTIONS|NSITE|Q)|REESPEECH|UTURE|ORUM)|G(?:A(?:MEHOST|LLERY)|ENEALOGY|OSSIP|UIDE)|W(?:H(?:OSWHO|ITE)|EBHOST|IKIA)|L(?:INK(?:FARM)?|A[BW]|YRICS)|M(?:(?:EMORI|ANU)AL|IRROR)|T(?:EXTBOOK|VGUIDE|RAVEL)|#DIC(?:T(?:IONARY)?|DEF)|E(?:VERYTHING|SSAY)|O(?:BITUARY|PINION)|J(?:OURNAL|ARGON)|HO(?:STING|WTO)|(?:IMAG|QUOT)E|NEWS(?:PAPER)?|YELLOW)?|SALESMEN)|C(?:(?:RYSTA(?:LBAL)?|BAL)L|H(?:OICE|AOS)|ENSOR(?:ED)?|OMPULSORY)|P(?:R(?:O(?:MO(?:TION)?|PAGANDA)|ESSRELEASE)|L(?:OT|UG)|APER)|B(?:A(?:TTLE(?:GROUND)?|DIDEA|LL)|UR(?:EAU|O))|R(?:E(?:LEASENOTES|QUIRED)|AWDATA|UMOUR)|I(?:N(?:DISCRIMINATE|KLESS)|INFO)|S(?:OAP(?:BOX)?|PECULATION)|D(?:EM(?:OCRACY)?|IARY)|F(?:ACTIONS|UTURE|ORUM)|WH(?:ATISTOBEDONE|IM)|G(?:AMEGUID|RUDG)E|YELLOW(?:PAGES)?|UNCENSORED|LINKFARM|!)|ikipedia:What Wikipedia is not)\b)
Wikipedia:Wikipedia is not a dictionary	Content	(?:\bW(?:P:(?:(?:WORDISSUBJEC|POINTWIK)T|N(?:OT(?:DIC|NEO)|AD|EO)|ISA(?:TERM|WORD)FOR|DICDEF)|ikipedia:Wikipedia is not a dictionary)\b)
Wikipedia:Civility	Conduct	(?:\bW(?:P:(?:I(?:DENTIFYUNCIVIL|UC)|R(?:EMOVEUNCIVIL|UC)|ESDO(?:NT)?S|CIV(?:IL)?|UNCIVIL)|ikipedia:Civility)\b)
Wikipedia:Clean start	Conduct	(?:\bW(?:P:(?:CLEAN|FRESH|NEW)START|ikipedia:Clean start)\b)
Wikipedia:Consensus	Conduct	(?:\bW(?:P:(?:C(?:ON(?:A(?:CHIEVE|DMIN)|L(?:IMITED|EVEL)|EXCEPT|S)?|CC)|(?:(?:IMPLIC|ED)IT|LOCAL)CONSENSUS|(?:TALKDONTREVER|OTHERPAREN)T|(?:ADMIN|FORUM)SHOP|NOCON(?:SENSUS)?)|ikipedia:Consensus)\b)
Wikipedia:Dispute resolution	Conduct	(?:\bW(?:P:(?:D(?:IS(?:ENGAG|PUT)E|R(?:#RfCs)?)|CON(?:DUC|TEN)TDISPUTE|SEEKHELP|FOC)|ikipedia:Dispute resolution)\b)
Wikipedia:Edit warring	Conduct	(?:\bW(?:P:(?:(?:(?:AVOIDEDIT)?WA|(?:[014]|NOT3)R)R|3RR(?:BLP|NO)?|E(?:DITWAR|W))|ikipedia:Edit warring)\b)
Wikipedia:Editing policy	Conduct	(?:\bW(?:P:(?:E(?:DIT(?:ING)?|P(?:TALK)?)|(?:UNRESPONSIV|HANDL)E|P(?:ERFECTION|RESERVE)|CA(?:UTIOUS|NTFIX)|W(?:ONTWORK|PEDIT)|(?:NOT|IM)PERFECT|FIXTHEPROBLEM|DON)|ikipedia:Editing policy)\b)
Wikipedia:Harassment	Conduct	(?:\bW(?:P:(?:H(?:A(?:R(?:ASS)?|#NOT)?|OUND(?:ING)?|USH|NE)|P(?:OSTEMAIL|RIVACY)|(?:EMAILPOS|NPL)T|WIKIHOUND(?:ING)?|O(?:UTING|WH)|D(?:OX|WH)|FOLLOWING|AOHA)|ikipedia:Harassment)\b)
Wikipedia:No personal attacks	Conduct	(?:\bW(?:P:(?:P(?:ERSONAL(?:ATTACKS)?|A)|NPA(?:#WHATIS)?|(?:WIA|R)PA|AVOIDYOU)|ikipedia:No personal attacks)\b)
Wikipedia:Ownership of content	Conduct	(?:\bW(?:P:(?:O(?:WN(?:ER(?:SHIP)?|BEHAVIOR)?|AS)|S(?:TEWARDSHIP|HEPHERD))|ikipedia:Ownership of content)\b)
Wikipedia:Sock puppetry	Conduct	(?:\bW(?:P:(?:S(?:OCK(?:#NOTIFY|LEGIT)?|TRAWSOCK|CRUTINY|HARE|PCU)|(?:MEA(?:TPUPPE)?|VALIDAL|ILLEGI)T|A(?:DMINSOCK|LTACCN)|LO(?:UTSOCK|GOUT)|RO(?:OMMAT|L)E|H(?:SOCK|AND)|D(?:OPP|G)|COWORKER|BADSOCK|FAMILY|EWLO|GHBH)|ikipedia:Sock puppetry)\b)
Wikipedia:Username policy	Conduct	(?:\bW(?:P:(?:(?:(?:DISRUPT|ATTACK|PROMO|CORP|REAL|ORG)NAM|B(?:LPABUS|ADNAM)|LATINPLEAS)E|U(?:SE(?:MODDOMAIN|RNAME)|NC(?:ONF)?|POL)|M(?:ULTI(?:ACCOUNT|PLE)|ISLEADNAME)|I(?:MPERSONAT(?:OR|E)|S?U)|NO(?:SHARING|NLATIN|EMOJI)|S(?:HAREDACCOUNT|PAMNAME))|ikipedia:Username policy)\b)
Wikipedia:Vandalism	Conduct	(?:\bW(?:P:(?:NO(?:TV(?:AND(?:ALISM)?)?|RESVAND)|V(?:AND(?:TYPES|NOT|AL)?|D)|S(?:POTVAN|NEAKY)|W(?:ARNVAND|HOIS)|MOVEVANDAL|TRACEIP|HTSV|RVAN)|ikipedia:Vandalism)\b)
Wikipedia:Attack page	Deletion	(?:\bW(?:P:(?:AT(?:TACK|P)|NEGATIVESPIN)|ikipedia:Attack page)\b)
Wikipedia:Criteria for speedy deletion	Deletion	(?:\bW(?:P:(?:G(?:[23456789]|1[01234]?|CSD)|F(?:[23456789]|1[01]|CSD)|A(?:[23579]|1[01]?|CSD)|C(?:SD(?:#F1)?|CSD|1)|U(?:[1235]|CSD)|R(?:[234]|CSD)|P(?:[12]|CSD)|T(?:[23]|CSD)|(?:NOT|O)CSD|X(?:CSD|2)|SPEEDY)|ikipedia:Criteria for speedy deletion)\b)
Wikipedia:Deletion policy	Deletion	(?:\bW(?:P:(?:D(?:EL(?:#(?:PROCESSES|CONTENT|REASON)|-(?:PROCESSES|CONTENT|REASON)|AFD|ETE)?|P(?:AFD)?)|ATD(?:-(?:[EIMR]|T(?:RANS)?))?|BIODEL(?:ETE)?|PERMADEL|CBLANK|UDP)|ikipedia:Deletion policy)\b)
Wikipedia:Oversight	Deletion	(?:\bW(?:P:(?:O(?:S(?:POL)?|VER)|SUPPRESS)|ikipedia:Oversight)\b)
Wikipedia:Proposed deletion	Deletion	(?:\bW(?:P:(?:(?:CONTESTE|DEPRO|SECON)D|PR(?:OD(?:NOM)?|D))|ikipedia:Proposed deletion)\b)
Wikipedia:Proposed deletion (books)	Deletion	(?:\bW(?:ikipedia:Proposed deletion (books)|P:B(?:OOK)?PROD)\b)
Wikipedia:Proposed deletion of biographies of living people	Deletion	(?:\bW(?:ikipedia:Proposed deletion of biographies of living people|P:(?:BLPPROD|STICKY))\b)
Wikipedia:Revision deletion	Deletion	(?:\bW(?:P:(?:R(?:EVDEL(?:REQUEST)?|VDL)|CF?RD)|ikipedia:Revision deletion)\b)
Wikipedia:Administrators	Enforcement	(?:\bW(?:P:(?:A(?:DMIN(?:A(?:BUSE|CCT)|ISTRATORABUSE|COND)?|NYUSER)|IN(?:ACTIVITY|VOLVED)|MOP(?:RIGHTS|FIGHT)?|S(?:ECUREADMIN|YSOP)|(?:NOBIG)?DEAL|W(?:HEEL|W)|TOOLMISUSE|UNINVOLVED|RAAA|0WW)|ikipedia:Administrators)\b)
Wikipedia:Banning policy	Enforcement	(?:\bW(?:P:(?:B(?:AN(?:BLOCKDIFF|LENGTH|REVERT|POL|EX)?|LOCKBANDIFF|MB)|C(?:ONDUCTTOBANNED|BAN)|RE(?:CIDIVISM|VERTBAN)|T(?:HREESTRIKES|BAN)|P(?:ROXYING|BAN)|(?:[AIS]|UN)BAN|3(?:STRIKES|X))|ikipedia:Banning policy)\b)
Wikipedia:Blocking policy	Enforcement	(?:\bW(?:P:(?:B(?:LOCK(?:EV(?:IDENCE|ASION)|P(?:REVENTATIVE)?|NO(?:TPUNITIVE)?|DETERRENT|ME)?|E(?:FOREBLOCK(?:ING)?)?|P)|C(?:O(?:NDUNBLOCK|LLATERAL|OLDOWN)|UBL|DB)|(?:S(?:ELF|OFT)|HARD|WHY)BLOCK|E(?:VA(?:SION|DE)|XPLAINBLOCK)|N(?:EVERUNBLOCK|OPUNISH)|O(?:PTIONS|SBL)|INDEF|GB)|ikipedia:Blocking policy)\b)
Wikipedia:Page protection policy	Enforcement	(?:\bW(?:P:(?:P(?:R(?:E(?:EMPTIVE|FER)|OTECT)|P(?:INDEF|LIST|DRV)?|(?:URPLE|INK)LOCK|ERM-PRO|TPROT|CPP)|S(?:(?:KYBLUE|ILVER)LOCK|(?:UPERPROTEC|AL)T|EMI)|(?:G(?:REEN|OLD)|BL(?:ACK|UE)|ORANGE|RED)LOCK|T(?:URQUOISELOCK|PROT)|W(?:HITELOCK|MF-PRO)|UP(?:LOAD-P|P?ROT)|(?:MOV|EC)P|NO-PREEMPT|CASCADE|FULL)|ikipedia:Protection policy)\b)
Wikipedia:Child protection	Legal	(?:\bWikipedia:Child protection\b)
Wikipedia:Copyright violations	Legal	(?:\bW(?:ikipedia:Copyright violations|P:(?:CVTOOLS|DCV))\b)
Wikipedia:Copyrights	Legal	(?:\bW(?:P:(?:COPY(?:LINKS?|OTHERS)|LINKVIO)|ikipedia:Copyrights)\b)
Wikipedia:Libel	Legal	(?:\bWikipedia:Libel\b)
Wikipedia:No legal threats	Legal	(?:\bWikipedia:No legal threats\b)
Wikipedia:Non-discrimination	Legal	(?:\bWikipedia:Non-discrimination policy\b)
Wikipedia:Non-free content criteria	Legal	(?:\bW(?:ikipedia:Non-free content criteria|P:NFCC[EP])\b)
Wikipedia:Paid-contribution disclosure	Legal	(?:\bWikipedia:Paid-contribution disclosure\b)
Wikipedia:Reusing Wikipedia content	Legal	(?:\bWikipedia:Reusing Wikipedia content\b)
Wikipedia:Terms of use	Legal	(?:\bWikipedia:Terms of use\b)
Wikipedia:Arbitration Committee/CheckUser and Oversight	Procedural	(?:\bW(?:ikipedia:Arbitration Committee/CheckUser and Oversight|P:CUOS)\b)
Wikipedia:Arbitration/Policy	Procedural	(?:\bW(?:P:(?:A(?:RB(?:COND|POL)|P)|RECUSAL)|ikipedia:Arbitration/Policy)\b)
Wikipedia:Bot policy	Procedural	(?:\bW(?:P:(?:B(?:OT(?:(?:US(?:ERSPAC)?|REQUIR|ISSU)E|A(?:PP(?:ROV|E)AL|SSIST|CC)|(?:SCRIP|PCA)T|CO(?:NFIG|MM)|MULTIOP|BLOCK|FLAG|DEF)|AGREQ)|(?:CO(?:SMETIC|NTEXT)|INTERWIKI|EXEMPT|SPELL)BOT|M(?:ASSCREATION|EATBOT)|A(?:DMINBOTS?|SSISTED))|ikipedia:Bot policy)\b)
Wikipedia:CheckUser	Procedural	(?:\bW(?:P:(?:NOTFISHING|PIXIEDUST)|ikipedia:CheckUser)\b)
Wikipedia:Edit filter helper	Procedural	(?:\bWikipedia:Edit filter helper\b)
Wikipedia:Event coordinator	Procedural	(?:\bWikipedia:Event coordinator\b)
Wikipedia:File mover	Procedural	(?:\bW(?:P:F(?:ILEREDIRECT|M(?:V/W|NN))|ikipedia:File mover)\b)
Wikipedia:Global rights policy	Procedural	(?:\bW(?:ikipedia:(?:Global rights policy|OTRS members)|P:GLOBALBOTS)\b)
Wikipedia:Interface administrators	Procedural	(?:\bWikipedia:Interface administrators\b)
Wikipedia:IP block exemption	Procedural	(?:\bW(?:P:(?:IPE(?:XEMPTCONDITIONS|C(?:PROXY)?)|GIPBE)|ikipedia:IP block exemption)\b)
Wikipedia:New pages patrol/Reviewers	Procedural	(?:\bWikipedia:New pages patrol/Reviewers\b)
Wikipedia:Open proxies	Procedural	(?:\bWikipedia:Open proxies\b)
Wikipedia:Page mover	Procedural	(?:\bW(?:P:(?:PM(?:R[CR]|VRC)|ROBIN)|ikipedia:Page mover)\b)
Wikipedia:Policies and guidelines	Procedural	(?:\bW(?:P:(?:P(?:G(?:(?:CHANG|LIF)E|BOLD)|OL(?:ICIES|CON)|ROPOSAL)|(?:ENFORCEMEN|TALKFIRS|NOTPAR)T|HISTORICAL|GUIDES)|ikipedia:Policies and guidelines)\b)
Wikipedia:Template editor	Procedural	(?:\bW(?:ikipedia:Template editor|P:TPE(?:REVOKE|GRANT))\b)
Wikipedia:Volunteer response team	Procedural	(?:\bWikipedia:Volunteer Response Team\b)
Wikipedia:Wikimedia policy	Procedural	(?:\bWikipedia:Wikimedia policy\b)
Wikipedia:Ignore all rules	Miscellaneous	(?:\b(?:W(?:ikipedia:Ignore all rules|P:I(?:GNORE|AR))|w.wiki/i)\b)
Wikipedia:Password strength requirements	Miscellaneous	(?:\bW(?:ikipedia:Password strength requirements|P:(?:STRONGPASS|PSR))\b)
Wikipedia:Assume good faith	Behavioral	(?:\bW(?:P:(?:G(?:OODFAITH|F)|A(?:GFC?|OBF)|FAITH|DGF)|ikipedia:Assume good faith)\b)
Wikipedia:Conflict of interest	Behavioral	(?:\bW(?:P:(?:C(?:O(?:I(?:(?:A(?:TTRIBUT|DVIC)|RESPONS)E|C(?:O(?:PYRIGHT|IN)|AMPAIGN)|P(?:AYDISCLOSE|OLITICAL)| is not simply bias|DISCLOSEPAY|NOTBIAS|LEGAL|EDIT|SELF|TALK|BLP|U)?|(?:NFLIC|VER)T)|URATOR)|P(?:A(?:ID(?:ATTRIBUTE|COPYRIGHT)|Y(?:TALK)?)|OTENTIALCOI|E)|(?:A(?:PPARENT|CTUAL)|F)COI|(?:SELF(?:PROMO|CI)T|UP)E|NO(?:HIDDENADS|P(?:AY|R))|D(?:ISCLOSE|COI)|EXTERNALREL|Open a COIN|LUC)|ikipedia:Conflict of interest)\b)
Wikipedia:Disruptive editing	Behavioral	(?:\bW(?:P:(?:D(?:IS(?:RUPT(?:SIGNS)?)?|(?:AP|D)?E|ONTGETIT)|I(?:D(?:IDNTHEARTHA|H)T|CANTHEARYOU)|NOTGETTINGIT|RUNAWAY|CTDAPE|LISTEN|HUH?)|ikipedia:Disruptive editing)\b)
Wikipedia:Do not disrupt Wikipedia to illustrate a point	Behavioral	(?:\bW(?:ikipedia:Do not disrupt Wikipedia to illustrate a point|P:(?:NOTPOINTy|POINTy?))\b)
Wikipedia:Etiquette	Behavioral	(?:\bW(?:P:(?:AVOIDABUSE|E(?:TI)?Q|INDCRIT|DOOR|WQT?)|ikipedia:Etiquette)\b)
Wikipedia:Please do not bite the newcomers	Behavioral	(?:\bW(?:ikipedia:Please do not bite the newcomers|P:(?:N(?:EWBIES|OOB)|(?:BIT|IJM)E|DBN))\b)
Wikipedia:Signatures	Behavioral	(?:\bW(?:P:(?:S(?:IG(?:#(?:N(?:[LT]|o(?:Templates|n-Latin|CAT))|CustomSig|[DE]L)|L(?:EN(?:GTH)?|INK)|N(?:(?:ATU|HE)RE)?|FO(?:RGE|NT)|IMAGE|PROB|APP|HOW)?|ignature forgery)|(?:(?:[345]|FOUR)TILDE|NL)S|Appearance and color|CUSTOMSIG|UNSIGNED|TILDE|~)|ikipedia:Signatures)\b)
Wikipedia:Talk page guidelines	Behavioral	(?:\bW(?:P:(?:T(?:ALK(?:#(?:(?:C(?:OMMUNIC|RE)AT|OBJECTIV|US)E|(?:DISCUS|FACT)S|NOMETA)|C(?:ENT|OND)|N(?:EW|O)|O)?|P(?:G(?:#YES)?|OC?|YES|NO)|OPPOST)|(?:(?:BOTTOM|CROSS-)PO|EXHAU)ST|(?:ARCHIVENOTDELET|INTERSPERS)E|S(?:HOUT(?:ING)?|PEAKENGLISH)|REDACT(?:ED)?|OWNTALK|MULTI)|ikipedia:Talk page guidelines)\b)
Wikipedia:User pages	Behavioral	(?:\bW(?:P:(?:U(?:P(?:#(?:P(?:RO(?:TECT|MO)|OLEMIC)|DEL(?:TALK|ETE)|NOT(?:SUITED)?|C(?:OPIES|MT)|G(?:AME|OAL)S|OWN|SUB)|GOOD|NOT|YES)?|SER(?:(?:SUB)?PAGE|TALKBLOG|BIO)?|OWN)|S(?:TALE(?:DRAFT)?|MI)|(?:FAKEARTICL|ORANG)E|N(?:EWMESSAGE|OBAN)|CREATEUSER#SUB|BLANKING|DELTALK|POLEMIC|REMOVED)|ikipedia:User pages)\b)
Wikipedia:Appealing a block	Behavioral	(?:\bW(?:P:(?:A(?:P(?:PEAL|B)|AB)|UNBLOCK)|ikipedia:Appealing a block)\b)
Wikipedia:Canvassing	Behavioral	(?:\bW(?:P:(?:VOTESTACK(?:ING)?|CAN(?:VAS)?|APPNOTE|STEALTH)|ikipedia:Canvassing)\b)
Wikipedia:Changing username	Behavioral	(?:\bW(?:ikipedia:Changing username/Guidelines|P:CHUG)\b)
Wikipedia:Courtesy vanishing	Behavioral	(?:\bW(?:P:(?:VANISH(?:ED )?|CV(?:AN|UT)|LEAVE|RTV)|ikipedia:Courtesy vanishing)\b)
Wikipedia:Deceased Wikipedians guidelines	Behavioral	(?:\bW(?:ikipedia:Deceased Wikipedians/Guidelines|P:DWG)\b)
Wikipedia:Gaming the system	Behavioral	(?:\bW(?:P:(?:S(?:ANCTIONGAM(?:ING|E)|PURIOUSPROTECT|TONEWALL)|GA(?:M(?:(?:ETYP)?E|ING)|SLIGHT(?:ING)?)|F(?:ORCEDINTERPRET|ILIBUSTER)|ONEHANDGIVES|PLAYPOLICY)|ikipedia:Gaming the system)\b)
Wikipedia:Linking to external harassment	Behavioral	(?:\bW(?:ikipedia:Linking to external harassment|P:LINKLOVE)\b)
Wikipedia:Responding to threats of harm	Behavioral	(?:\bW(?:P:(?:(?:VIOLENC|SUICID)E|EMERGENCY|URGENT|911 )|ikipedia:Responding to threats of harm)\b)
Wikipedia:Reviewing pending changes	Behavioral	(?:\bW(?:ikipedia:Reviewing pending changes|P:RPC)\b)
Wikipedia:Rollback	Behavioral	(?:\bW(?:P:R(?:OLL(?:BACK(?:USE)?)?|BK)|ikipedia:Rollback)\b)
Wikipedia:Spam blacklist	Behavioral	(?:\bW(?:ikipedia:Spam blacklist|P:(?:BLACKLIST|SPB))\b)
Wikipedia:Autobiography	Content guide	(?:\bW(?:P:(?:A(?:UTO(?:#IFEXIST|BIOG?|PROB)?|B)|YOURSELF)|ikipedia:Autobiography)\b)
Wikipedia:Citing sources	Content guide	(?:\bW(?:P:(?:I(?:N(?:LINEC(?:ITE(?:CLUTTER)?|LUTTER)|TE(?:GRITY|XT)|DICATEAVAIL|CITE)|LCLUTTER|BID)|C(?:ITE(?:(?:BUNDL|TYP)E|S(?:HORT|TYLE)|CONSENSUS|FOOT|HOW|VAR|WEB)?|S)|S(?:AYWHERE(?:YOU(?:READ|GOT)IT)?|OURCELINKS|WY[GR]T|FN)|(?:WH(?:EN(?:NOTCIT|INROM)|YCIT)|(?:HOW|NO)CIT)E|B(?:OOKLINKS|UNDLING|LPCITE)|D(?:UPCITES|EADREF)|PAGE(?:LINKS|NUM)|G(?:BOOKS|ENREF)|ASL|REF)|ikipedia:Citing sources)\b)
Wikipedia:Content forking	Content guide	(?:\bW(?:P:(?:C(?:ONTENTFORK(?:ING)?|FORK)|RE(?:DUNDANTFORK|LART?)|POV(?:SPLIT|FORK)|S(?:PINOFF|UBPOV))|ikipedia:Content forking)\b)
Wikipedia:External links	Content guide	(?:\bW(?:P:(?:E(?:L(?:M(?:IN(?:OFFICIAL)?|AYBE)|B(?:URDEN|LP)|PO(?:INTS|V)|D(?:EAD|UP)|N(?:EVER|O)|R(?:EG|C)|T(?:EMP)?|OFFICIAL|#ADV|CITE|LIST|YES|WD)?|XT)|(?:COPYVIO|NONENG)EL|Y(?:OUTUBE|T)|LINKSTOAVOID|RICHMEDIA|ADV)|ikipedia:External links)\b)
Wikipedia:Fringe theories	Content guide	(?:\bW(?:P:(?:F(?:R(?:IN(?:GE(?:LEVEL|/PS|BLP)?|D)|NG)|DESC)|(?:EVAL|BLP|N)FRINGE|P(?:ROFRINGE|ARITY)|ONEWAY|DESCF|ITA)|ikipedia:Fringe theories)\b)
Wikipedia:Images	Content guide	(?:\bW(?:P:(?:PICTURES?|IMAGES?)|ikipedia:Images)\b)
Wikipedia:No disclaimers in articles	Content guide	(?:\bW(?:P:(?:N(?:ODISCLAIMERS|D[AT])|DISCLAIM)|ikipedia:No disclaimers in articles)\b)
Wikipedia:Non-free content	Content guide	(?:\bW(?:P:(?:N(?:F(?:C(?:[IP]|#(?:UU(?:LP|I)|CS)|C(?:EG?|P))?|LISTS|TABLE|EXMP|G)|ONFREE)|I(?:mage resolution|MAGERES)|F(?:AIRUSE |REER)?|TOP100|GETTY)|ikipedia:Non-free content)\b)
Wikipedia:Plagiarism	Content guide	(?:\bW(?:P:(?:(?:FREECOPYIN|NONENGPLA)G|PLAG(?:FORMS?|IARISM)?)|ikipedia:Plagiarism)\b)
Wikipedia:Reliable sources	Content guide	(?:\bW(?:P:(?:R(?:S(?:/(?:[AM]C|SPS)|BREAKING|CONTEXT|OPINION|PRIMARY| AGE|SELF)?|EL(?:IAB(?:ILITY|LE)|Y))|S(?:CHOLARSHIP|OURCETYPES|ELFSOURCE|PONSORED)|U(?:SE(?:RG(?:ENERATED)?|BYOTHERS)|BO|GC)|(?:CONTEXTMATTE|WPNOT)RS|A(?:GE MATTERS|FFILIATE)|P(?:UBLISHED|ARTISAN)|QUESTION(?:ABLE|ED)|BIASED(?:SOURCES)?|NEWSORG)|ikipedia:Reliable sources)\b)
Wikipedia:Spoiler	Content guide	(?:\bW(?:P:(?:S(?:POIL(?:ER(?:ALERT)?)?|W )|PREVIEWS)|ikipedia:Spoiler)\b)
Wikipedia:Wikipedia is not for things made up one day	Content guide	(?:\bW(?:ikipedia:Wikipedia is not for things made up one day|P:(?:N(?:OTMADEUP|FT)|SCRABBLE|MADEUP|ONEDAY|1DAY ))\b)
Wikipedia:Accuracy dispute	Content guide	(?:\bW(?:P:(?:D(?:ISPUTED|UBIOUS)|AD)|ikipedia:Accuracy dispute)\b)
Wikipedia:Wikipedia:Anarchism referencing guidelines	Content guide	(?:\bW(?:P:A(?:N(?: OPINION|CITE)|LL ANARCHISTS|RGH)|ikipedia:Anarchism referencing guidelines)\b)
Wikipedia:Do not create hoaxes	Content guide	(?:\bW(?:P:(?:D(?:(?:ONT|W)HOAX|NCH)|N(?:OHOAXES|HOAX)|HOAX)|ikipedia:Do not create hoaxes)\b)
Wikipedia:Do not include the full text of lengthy primary sources	Content guide	(?:\bW(?:ikipedia:Do not include the full text of lengthy primary sources|P:N(?:OFULLTEXT|PS))\b)
Wikipedia:Logos	Content guide	(?:\bW(?:P:(?:BANDLOGO|LOGOS?)|ikipedia:Logos)\b)
Wikipedia:No 3D illustrations	Content guide	(?:\bW(?:ikipedia:No 3D illustrations|P:3D)\b)
Wikipedia:Non-U.S. copyrights	Content guide	(?:\bW(?:ikipedia:Non-U.S. copyrights|P:(?:NUSC|URAA))\b)
Wikipedia:Offensive material	Content guide	(?:\bW(?:P:(?:(?:BOWDLERIZ|PROFAN)E|G(?:RATUITOUS|FFENSE)|F*\**|SHIT|OM)|ikipedia:Offensive material)\b)
Wikipedia:Patent nonsense	Content guide	(?:\bW(?:P:(?:P(?:ATENT|N)|NONSENSE)|ikipedia:Patent nonsense)\b)
Wikipedia:Portal guidelines	Content guide	(?:\bW(?:ikipedia:Portal/Guidelines|P:PO(?:RT)?G)\b)
Wikipedia:Spam	Content guide	(?:\bW(?:P:(?:SPAM(?:LINKS?|#LINK|BAIT|MER)?|A(?:D(?:MAS[KQ]|S)|RTSPAM)|(?:CITE|LINK|REF)SPAM|B(?:OOKSPAM|ROCHURE)|OTHERSPAM(?:EXISTS)?|EXTPROMO)|ikipedia:Spam)\b)
Wikipedia:Television Episodes	Content guide	(?:\bW(?:ikipedia:Television episodes|P:(?:EPISODE|TVEP))\b)
Wikipedia:Record Charts	Content guide	(?:\bW(?:P:(?:(?:(?:B(?:ILLBOAR|A)|GOO)D|OKAY|US)CHARTS|SINGLE(?:NETWORK|VENDOR)|CHART(?:MATH|TRAJ)?)|ikipedia:Record charts)\b)
Wikipedia:WikiProject Days of the year articles	Content guide	(?:\bW(?:P:(?:D(?:O(?:Y(?:CITE)?|TY)|EATHDOY)|BIRTHDOY|NGS)|ikipedia:Days of the year)\b)
Wikipedia:Video games articles	Content guide	(?:\bW(?:P:(?:VG(?:/(?:P(?:O[PV]|LOT)|(?:MIXE|LEA)D|RE(?:LEASE|C)|DATE(?:CAT)?|CONTENT|NONENG|STYLE|EL|JP)|IMAGES|JARGON|LAYOUT|ORDER|SCOPE|BOX)|GAMECRUFT|MOSVG|JFN)|ikipedia:Manual of Style/Video games)\b)
Wikipedia:Deletion process	Deletion	(?:\bW(?:P:(?:D(?:PR(?:#(?:[ACFMRT]FD|DRV|NAC))?|ELPRO(?:#(?:[ACFMRT]FD|DRV))?)|(?:P(?:ROCEDURAL)?CLOS|BIGDELET)E|S(?:(?:OFTDELET|CLOS)E|EARCHDEL)|N(?:OQUORUM|ACD)|WITHDRAWN|RELIST|EARLY|XFD)|ikipedia:Deletion (?:proces|forum|venue)s)\b)
Wikipedia:Speedy keep	Deletion	(?:\bW(?:P:(?:SK(?:(?:#NO|CRI)T)?|KEEP|CSK)|ikipedia:Speedy keep)\b)
Wikipedia:Deletion guidelines for administrators	Deletion	(?:\bW(?:ikipedia:Deletion guidelines for administrators|P:(?:ROUGHCONSENSUS|DGFA))\b)
Wikipedia:Article size	Editing	(?:\bW(?:P:(?:S(?:(?:UBARTIC|IZERU)LE|P(?:LITLIS|INOU)T)|(?:CHOKIN|TOOBI)G|(?:RP|A)S|LENGTH|HASTE)|ikipedia:Article size)\b)
Wikipedia:Be bold	Editing	(?:\bW(?:P:(?:B(?:OLD(?:NOTOBLIGATORY)?|NO|B)|(?:SO)?FIXIT|RECKLESS|CAREFUL|GLC)|ikipedia:Be bold)\b)
Wikipedia:Disambiguation	Editing	(?:\bW(?:P:(?:D(?:AB(?:N(?:O(?:INCLUDE|T)|AME)|A(?:CRONYM|BBREV)|CO(?:MBINE|NCEPT)|S(?:ISTER|TYLE)|DI(?:SPLAY|C)|RE(?:LATED|F)|LINKS?)?|ETERMINEPRIMARY|(?:OUBLE)?DAB|ISAMBIG|PAGES?|LINKS|BC)?|P(?:RIMARY(?:REDIRECT|TOPIC|USAGE)|T(?:OPIC|M)|ARTIAL)|IN(?:TDAB(?:LINK|S)?|C(?:OMP)?DAB)|N(?:OPRIMARY|AMELIST|WFCTM|CDAB)|F(?:IXDABLINKS|URTHERDAB)|T(?:(?:ITLE)?PTM|WODABS)|(?:CONCEPT|HOWTO)DAB|BUTIDONTKNOWABOUTIT|(?:MULTI|2)DABS|ONEOTHER)|ikipedia:(?:Disambiguation|PRIMARYRED))\b)
Wikipedia:Technical articles	Editing	(?:\bW(?:P:(?:O(?:VERSIMPLIFY|NEDOWN)|TECH(?:-CONTENT|NICAL)|EXPLAINLEAD|UPFRONT|MTAU)|ikipedia:Make technical articles understandable)\b)
Wikipedia:Categories, lists, and navigation templates	Editing	(?:\bW(?:P:(?:BIDI(?:RECTIONAL)?|N(?:OTDUPE?|AVBOX)|(?:FILM|PERF)NAV|LINKBACK|AOA[CL]|DOA[CL]|SIDEBAR|CLNT?)|ikipedia:Categories, lists, and navigation templates)\b)
Wikipedia:Categorization	Editing	(?:\bW(?:P:(?:(?:T(?:EMPLATE|OPIC)?|HIDDEN|USERNO|FILE|MOS)CAT|C(?:AT(?:DEF(?:INING)?|V(?:ER)?|#[TV]|EGORY)?|G)|S(?:(?:U(?:PER|B)|ET)CAT|ORTKEY)|D(?:(?:RAFTNO|UP)CAT|IFFUSE)|EPON(?:YMOUS)?|PROJCATS)|ikipedia:Categorization)\b)
Wikipedia:Categorization of people	Editing	(?:\bW(?:P:(?:(?:(?:EPCATP|PE)ER|LISTA)S|COP(?:S(?:EP)?|DEF|#N|/S)?|S(?:EPARATE|UR)|NAMESORT|MCSTJR)|ikipedia:Categorization of people)\b)
Wikipedia:People by year	Editing	(?:\bW(?:ikipedia:People by year|P:PBY)\b)
Wikipedia:Categorization by ethnicity, gender, religion and sexuality	Editing	(?:\bW(?:P:(?:CAT(?:/(?:EGRS|GRS |R)|G(?:ENDER|RS)|EGRS)|E(?:THNICRACECAT|GRS)|FINAL RUNG|GHETTO)|ikipedia:Categorization/Ethnicity, gender, religion and sexuality)\b)
Wikipedia:Redirect categories	Editing	(?:\bW(?:P:(?:(?:R(?:ED)?|LISTR)CAT|INCOMPATIBLE)|ikipedia:Categorizing redirects)\b)
Wikipedia:User categories	Editing	(?:\bW(?:P:U(?:SERCAT(?:YES|NO)?|CAT)|ikipedia:User categories)\b)
Wikipedia:Overcategorization	Editing	(?:\bW(?:P:(?:O(?:C(?:A(?:SSOC|WARD|T)|E(?:GRS|PON)|LOCATION|VENUE|MISC)?|(?:VER(?:LAP)?|PINION)CAT)|S(?:MALL(?:CAT)?|UBJECTIVECAT|HAREDNAME)|(?:ARBITRARY|CANDIDATE|PERF)CAT|N(?:ONDEF(?:INING)?|ARROWCAT)|T(?:RIVIALCAT|OPTEN))|ikipedia:Overcategorization)\b)
Wikipedia:Reviewing good articles	Editing	(?:\bW(?:ikipedia:Reviewing good articles|P:RGA)\b)
Wikipedia:Subpages	Editing	(?:\bW(?:P:(?:TITLESLASH|S(?:UB|P))|ikipedia:Subpages)\b)
Wikipedia:Copying within Wikipedia and Wikimedia	Editing	(?:\bW(?:P:(?:C(?:OPYWITHIN|WW)|ATT(?:REQ|SIT)|R(?:U[DU]|IA)|(?:NO|P)ATT|TFOLWP)|ikipedia:Copying within Wikipedia)\b)
Wikipedia:Hatnote use	Editing	(?:\bW(?:P:(?:H(?:AT(?:NOTE(?:PLACE|RULES)|EXTRA)?|N[PRS]?|RULES)|(?:(?:ONESHOR|LEGI)T|EL|TR|1)HAT|N(?:O(?:ARTICLE|TAMB)|AMB)|RE(?:LATED|DHAT)|SIMILAR)|ikipedia:Hatnote)\b)
Wikipedia:High-risk templates protection	Editing	(?:\bW(?:ikipedia:High-risk templates|P:H(?:IGHRISK|RT))\b)
Wikipedia:Page blanking	Editing	(?:\bW(?:P:(?:PAGEBLANKING|BLANK)|ikipedia:Page blanking)\b)
Wikipedia:Preparing images for upload	Editing	(?:\bW(?:ikipedia:Preparing images for upload|P:(?:PIFU|USOP))\b)
Wikipedia:Recent years	Editing	(?:\bW(?:ikipedia:Recent years|P:RY[BD]?)\b)
Wikipedia:Red links	Editing	(?:\bW(?:P:(?:RED(?:LINK(?:BIO|S)?|DEAL|NOT?|BIO|YES)?|CHECKAFTERCREATE|INCOMINGLINKS)|ikipedia:Red link)\b)
Wikipedia:Reference desk guidelines	Editing	(?:\bW(?:ikipedia:Reference desk/Guidelines|P:RD/G)\b)
Wikipedia:Substitution use	Editing	(?:\bW(?:P:(?:SUBST(?:(?:MUS|NO)T)?|TSUB)|ikipedia:Substitution)\b)
Wikipedia:Summary style	Editing	(?:\bW(?:P:(?:S(?:UMMARY|YNC|S)|AVOIDSPLIT|DETAIL)|ikipedia:Summary style)\b)
Wikipedia:Updating articles	Editing	(?:\bWikipedia:Updating information\b)
Wikipedia:Version 1.0 Editorial Team assessment	Editing	(?:\bW(?:P:(?:(?:NONSTANDARDCLA|ASSE)SS|1.0/A)|ikipedia:Content assessment)\b)
Wikipedia:Broad concept articles	Editing	(?:\bW(?:P:(?:DABCON(?:G(?:AME|EO|OV)|P(?:HYS|ROD)|BRAND|SPORT|MATH|OFF)|B(?:ROAD(?:CONCEPT)?|CA))|ikipedia:Broad-concept article)\b)
Wikipedia:Recent year articles	Editing	(?:\bW(?:ikipedia:Recent years|P:RY[BD]?)\b)
Wikipedia:Stubs	Editing	(?:\bW(?:P:(?:S(?:TUB(?:S(?:PACING)?|DEF|IFY)?|VSP)|(?:IDEAL|NEW|TAG|DE)STUB|P(?:ROJSTUB|SA))|ikipedia:Stub)\b)
Wikipedia:Set index articles	Editing	(?:\bW(?:P:(?:S(?:ET(?:NOTDAB|INDEX)|IA(?:NOTDAB)?)|NOTDAB)|ikipedia:Set index articles)\b)
Wikipedia:Redirects	Editing	(?:\bW(?:P:(?:R(?:#(?:C(?:ATEGORY|RD)|ASTONISH|SUPPRESS|HARMFUL|DELETE|KEEP|PLA)|EDIR(?:ECTPROTECTION)?|P(?:ROTECTION|URPOSE)|NEUTRAL|SECT|TOA)?|B(?:LA(?:NKANDREDIRECT|R)|RINT)|N(?:AVNOREDIRECT|OTBROKEN)|(?:DONOTFIXI|TARGE)T|(?:SELF|ED)RED|POFR)|ikipedia:Redirect)\b)
Wikipedia:Soft redirects	Editing	(?:\bW(?:P:S(?:OFT(?:REDIR|TEMP)|RD)|ikipedia:Soft redirect)\b)
Wikipedia:Article titles	Naming conventions	(?:\bW(?:P:(?:N(?:A(?:M(?:INGCRITERIA|ECHANGES)|TURAL(?:NES|DI)S)|POV(?:TITL|NAM)E|DESC|OUN)|T(?:ITLE(?:(?:SPECIALCHARACTER|CHANGE)S|FORMAT|VAR|TM)?|RANSLITERATE|SC)|D(?:E(?:SCRIPDIS|FINITE)|IFF(?:PUNCT|CAPS))|P(?:OV(?:TITL|NAM)E|RECIS(?:ION|E)|ARENDIS)|C(?:O(?:MM(?:ONNAME|ADIS)|NCISE)|RITERIA)|(?:ITALICTITL|LOWERCAS)E|A(?:T(?:D(?:AB|IS))?|ND)|S(?:MALLDETAILS|INGULAR)|RECOGNIZABILITY|OTHERNAMES|U(?:CRN|E)|QUALIFIER|MOSAT)|ikipedia:Article titles)\b)
Wikipedia:Category names	Naming conventions	(?:\bW(?:ikipedia:Category names|P:(?:CATNAME|NCCAT))\b)
Wikipedia:File names	Naming conventions	(?:\bW(?:P:F(?:M(?:V/W|NN)|ILENAMES|NC)|ikipedia:File names)\b)
Wikipedia:Naming conventions (acronyms)	Naming conventions	(?:\bW(?:P:(?:ACRONYMTITLE|NCA(?:CRO)?|MOSABBR)|ikipedia:Manual of Style/Abbreviations)\b)
Wikipedia:Naming conventions (capitalization)	Naming conventions	(?:\bW(?:ikipedia:Naming conventions (capitalization)|P:NCC(?:APS|PT))\b)
Wikipedia:Naming conventions (country-specific topics)	Naming conventions	(?:\bW(?:ikipedia:Naming conventions (country-specific topics)|P:NCCST)\b)
Wikipedia:Naming conventions (definite or indefinite article at beginning of name)	Naming conventions	(?:\bW(?:ikipedia:Naming conventions (definite or indefinite article at beginning of name)|P:(?:NC(?:THE|AN)|THE(?:UNI)?))\b)
Wikipedia:Naming conventions (events)	Naming conventions	(?:\bW(?:P:(?:N(?:CE(?:VENTS)?|OYEAR)|D(?:ESCRIPTO|ISASTE)R)|ikipedia:Naming conventions (events))\b)
Wikipedia:Naming conventions (geographic names)	Naming conventions	(?:\bW(?:P:(?:N(?:C(?:P(?:LACE(?:DAB)?|HILIPPINE)|(?:FALKLA|I)ND|AUST|CS|GN)|BZ)|(?:S(?:COTLAND|RB)|U[KS]|VIET)PLACE|M(?:ODERNPLACENAME|PN)|PLACE(?:DAB)?|WIAN)|ikipedia:Naming conventions (geographic names))\b)
Wikipedia:Naming conventions (numbers and dates)	Naming conventions	(?:\bW(?:P:(?:NC(?:D(?:URATION|ATES)|NUM)|DATERANGETITLES)|ikipedia:Naming conventions (numbers and dates))\b)
Wikipedia:Naming conventions (long lists)	Naming conventions	(?:\bW(?:ikipedia:Naming conventions (long lists)|P:NC(?:L(?:ONGLIST|L)|SPLITLIST))\b)
Wikipedia:Naming conventions (people)	Naming conventions	(?:\bW(?:P:(?:M(?:IDDL(?:ENAM)?E|ONONYM|AIDEN)|N(?:C(?:P(?:DAB)?|BIO)|ICKNAME)|S(?:(?:INGL|TAG)ENAME|PNC)|(?:TITLESINTITLE|INIT)S|PSEUDONYM|JR/SR)|ikipedia:Naming conventions (people))\b)
Wikipedia:Naming conventions (plurals)	Naming conventions	(?:\bW(?:ikipedia:Naming conventions (plurals)|P:(?:PLURAL(?:PT)?|NCPLURAL))\b)
Wikipedia:Naming conventions (technical restrictions)	Naming conventions	(?:\bW(?:P:(?:NC(?:-(?:COLONS?|SLASH)|LOWERCASEFIRST|HASHTAG|TR)|TITLELENGTH)|ikipedia:Naming conventions (technical restrictions))\b)
Wikipedia:Naming conventions (use English)	Naming conventions	(?:\bW(?:P:(?:DI(?:ACRITICS|VIDEDUSE)|E(?:STABLISHED|NGLISH)|NCUE|UEIA)|ikipedia:Naming conventions (use English))\b)
Wikipedia:Aircraft	Naming conventions	(?:\bW(?:ikipedia:Naming conventions (aircraft)|P:(?:NCAIR(?:CRAFT)?|AIR/NC))\b)
Wikipedia:Ancient Romans	Naming conventions	(?:\bW(?:ikipedia:Naming conventions (ancient Romans)|P:(?:ROMANS|NCRN))\b)
Wikipedia:Armenian	Naming conventions	(?:\bW(?:ikipedia:Naming conventions (Armenian)|P:(?:NCARME(?:NIA)?|ARME)N)\b)
Wikipedia:Astronomical objects	Naming conventions	(?:\bW(?:ikipedia:Naming conventions (astronomical objects)|P:(?:(?:PLANET|STAR)NAMES|NCASTRO))\b)
Wikipedia:Australian roads	Naming conventions	(?:\bW(?:ikipedia:Naming conventions (Australian roads)|P:(?:AURDNAME|NCAURD))\b)
Wikipedia:Baseball players	Naming conventions	(?:\bW(?:ikipedia:Naming conventions (baseball players)|P:NC-?BASE)\b)
Wikipedia:Belgium: castle, country house, château and kasteel	Naming conventions	(?:\bWikipedia:WikiProject Belgium/Castle, country house, château and kasteel naming conventions\b)
Wikipedia:Belgium: alternate language names	Naming conventions	(?:\bWikipedia:WikiProject Belgium/Alternate language names\b)
Wikipedia:Books	Naming conventions	(?:\bW(?:P:(?:NC(?:B(?:OOKS|K)?|-BK)|SUBTITLES?|BOOKDAB)|ikipedia:Naming conventions (books))\b)
Wikipedia:Broadcasting	Naming conventions	(?:\bW(?:ikipedia:Naming conventions (broadcasting)|P:NC-?BC)\b)
Wikipedia:Brussels	Naming conventions	(?:\bWikipedia:WikiProject Belgium/Brussels naming conventions\b)
Wikipedia:Burmese	Naming conventions	(?:\bW(?:ikipedia:Naming conventions (Burmese)|P:BURMESE)\b)
Wikipedia:Chemistry	Naming conventions	(?:\bW(?:P:(?:C(?:HEMNAME|AES)|(?:NCCHE|ALU)M|MOSCHEM/NAME|SULF)|ikipedia:Naming conventions (chemistry))\b)
Wikipedia:Chinese	Naming conventions	(?:\bW(?:P:(?:NC-(?:CH(?:INA|N)|ZH)|(?:CHINES|ZHNAM)E)|ikipedia:Naming conventions (Chinese))\b)
Wikipedia:Clergy	Naming conventions	(?:\bW(?:ikipedia:Naming conventions (clergy)|P:(?:NC(?:CL|WC)|BISHOP))\b)
Wikipedia:College football	Naming conventions	(?:\bWikipedia:WikiProject College football/Naming conventions\b)
Wikipedia:Comics	Naming conventions	(?:\bW(?:ikipedia:Naming conventions (comics)|P:NCC(?:OMICS|/THE|DAB))\b)
Wikipedia:Companies	Naming conventions	(?:\bW(?:ikipedia:Naming conventions (companies)|P:NCCORP)\b)
Wikipedia:Ethnicities and tribes	Naming conventions	(?:\bW(?:ikipedia:Naming conventions (ethnicities and tribes)|P:(?:ETHNICGROUP|NCET(?:/A)?|TRIBE))\b)
Wikipedia:Fauna	Naming conventions	(?:\bW(?:ikipedia:Naming conventions (fauna)|P:(?:(?:MONOTYPI|N)C)?FAUNA)\b)
Wikipedia:Films	Naming conventions	(?:\bW(?:ikipedia:Naming conventions (films)|P:(?:NCF(?:ILMS?)?|PRIMARYFILM))\b)
Wikipedia:Flora	Naming conventions	(?:\bW(?:P:(?:NC(?:(cultivar)|FLORA)|(?:MONOTYPIC)?FLORA|CULTIVAR)|ikipedia:Naming conventions (flora))\b)
Wikipedia:Geographic names	Naming conventions	(?:\bW(?:P:(?:N(?:C(?:P(?:LACE(?:DAB)?|HILIPPINE)|(?:FALKLA|I)ND|AUST|CS|GN)|BZ)|(?:S(?:COTLAND|RB)|U[KS]|VIET)PLACE|M(?:ODERNPLACENAME|PN)|PLACE(?:DAB)?|WIAN)|ikipedia:Naming conventions (geographic names))\b)
Wikipedia:Government and legislation	Naming conventions	(?:\bW(?:ikipedia:Naming conventions (government and legislation)|P:NC(?:-(?:ELECT|GAL)|ELECT|GAL))\b)
Wikipedia:Greek	Naming conventions	(?:\bW(?:ikipedia:Naming conventions (Greek)|P:(?:NC)?GREEK)\b)
Wikipedia:Hebrew	Naming conventions	(?:\bW(?:ikipedia:Naming conventions (Hebrew)|P:(?:NCHE(?:BREW)?|HE(?:BREW)?))\b)
Wikipedia:Ice hockey	Naming conventions	(?:\bW(?:ikipedia:Naming conventions (ice hockey)|P:NCIH)\b)
Wikipedia:Indic	Naming conventions	(?:\bW(?:ikipedia:Naming conventions (Indic)|P:NCIN(?:DIC)?)\b)
Wikipedia:Irish categories	Naming conventions	(?:\bW(?:ikipedia:WikiProject Ireland/Ireland Category Norms|P:IRE-CATS)\b)
Wikipedia:Korean	Naming conventions	(?:\bW(?:ikipedia:Naming conventions (Korean)|P:NC(?:-(?:SoJ|KO)|KO(?:REAN)?))\b)
Wikipedia:Languages	Naming conventions	(?:\bW(?:ikipedia:Naming conventions (languages)|P:(?:NCL(?:ANG)?|DIALECT))\b)
Wikipedia:Law enforcement agency categories	Naming conventions	(?:\bW(?:ikipedia:Naming conventions (law enforcement agency categories)|P:LEAC(?:AT)?)\b)
Wikipedia:Latter Day Saints	Naming conventions	(?:\bW(?:ikipedia:Naming conventions (Latter Day Saints)|P:NCLDS)\b)
Wikipedia:Macedonia	Naming conventions	(?:\bW(?:ikipedia:Naming conventions (Macedonia)|P:(?:MOSMAC3?|NCMAC))\b)
Wikipedia:Manuscripts	Naming conventions	(?:\bW(?:ikipedia:Naming conventions (manuscripts)|P:NCMANU(?:SCRIPT)?)\b)
Wikipedia:Mining	Naming conventions	(?:\bW(?:ikipedia:WikiProject Mining/Style guide|P:MINESTYLE)\b)
Wikipedia:Mongolian	Naming conventions	(?:\bW(?:ikipedia:Naming conventions (Mongolian)|P:(?:(?:NC)?MO|RM)N)\b)
Wikipedia:Music	Naming conventions	(?:\bW(?:P:(?:(?:S(?:INGER|ONG)|COMPOSITION|ALBUM|EP)DAB|BAND(?:NAME|DAB)|NCM(?:USIC|DAB)?|MUSICSERIES|DABSONG)|ikipedia:Naming conventions (music))\b)
Wikipedia:New Zealand	Naming conventions	(?:\bW(?:ikipedia:Naming conventions (New Zealand)|P:NCNZ)\b)
Wikipedia:Norse mythology	Naming conventions	(?:\bW(?:ikipedia:Naming conventions (Norse mythology)|P:NCNM)\b)
Wikipedia:Operas	Naming conventions	(?:\bW(?:ikipedia:Naming conventions (operas)|P:NCO(?:PERA)?)\b)
Wikipedia:Political parties	Naming conventions	(?:\bW(?:ikipedia:Naming conventions (political parties)|P:NCP(?:ARTY|P))\b)
Wikipedia:Royalty and nobility	Naming conventions	(?:\bW(?:P:(?:NC(?:(?:BRIT)?PEER|R(?:AN|OY)|N(?:OB|T))|CO(?:GNOMEN|NSORTS)|SOVEREIGN|OBE)|ikipedia:Naming conventions (royalty and nobility))\b)
Wikipedia:Ships	Naming conventions	(?:\bW(?:P:(?:SH(?:IP(?:NAME|DAB)|E4SHIPS)|NC(?:S(?:HIP )?|-SHIPS?))|ikipedia:Naming conventions (ships))\b)
Wikipedia:Sports teams	Naming conventions	(?:\bW(?:ikipedia:Naming conventions (sports teams)|P:NCST)\b)
Wikipedia:Sportspeople	Naming conventions	(?:\bW(?:ikipedia:Naming conventions (sportspeople)|P:NCSP)\b)
Wikipedia:Stations in Poland	Naming conventions	(?:\bW(?:ikipedia:Naming conventions (stations in Poland)|P:NC-PLSTATIONS)\b)
Wikipedia:Swiss municipalities	Naming conventions	(?:\bWikipedia:WikiProject Swiss municipalities/Article title conventions\b)
Wikipedia:Television	Naming conventions	(?:\bW(?:P:(?:NC(?:TV(?:U[KS])?|[-:]TV)|TV(?:SEASON|-NC))|ikipedia:Naming conventions (television))\b)
Wikipedia:Tibetan	Naming conventions	(?:\bW(?:ikipedia:Naming conventions (Tibetan)|P:NC-TIBET)\b)
Wikipedia:UK Parliament constituencies	Naming conventions	(?:\bWikipedia:Naming conventions (UK Parliament constituencies)\b)
Wikipedia:UK stations	Naming conventions	(?:\bW(?:ikipedia:Naming conventions (UK stations)|P:(?:UKSTATION(?:DAB)?|NCUKSTATIONS))\b)
Wikipedia:US state and territory highways	Naming conventions	(?:\bW(?:ikipedia:Naming conventions (U.S. state and territory highways)|P:USSH)\b)
Wikipedia:Video games	Naming conventions	(?:\bW(?:ikipedia:Naming conventions (video games)|P:NC(?:GAMES(?:DAB)?|VG(?:DAB)?))\b)
Wikipedia:West Bank	Naming conventions	(?:\bW(?:ikipedia:Naming conventions (West Bank)|P:(?:WESTBANK|NCWB|J&S))\b)
Wikipedia:Writing systems	Naming conventions	(?:\bW(?:ikipedia:Naming conventions (writing systems)|P:NC(?:(WS)|WS))\b)
Wikipedia:Notability	Notability	(?:\bW(?:P:(?:N(?:O(?:T(?:E(?:WORTHY|SAL)?|TEMPORARY)|PAGE)|LISTITEM|POSSIBLE|EXIST|RVE?|TEMP|NC?)?|(?:(?:CON|LIS|AR)T|FAIL|WHY)N|S(?:USTAINED|IGCOV|PIP)|PAGEDECIDE|15MOF|GNG)|ikipedia:Notability)\b)
Wikipedia:Academics	Notability	(?:\bW(?:P:(?:N(?:ACADEMIC|PROF)|ACADEMIC|TEACHER |SCHOLAR|PROF)|ikipedia:Notability (academics))\b)
Wikipedia:Astronomical objects	Notability	(?:\bW(?:ikipedia:Notability (astronomical objects)|P:(?:NAST(?:CRIT|HELP|RO)|AST2000|DWMP))\b)
Wikipedia:Books	Notability	(?:\bW(?:P:(?:B(?:K(?:CR(?:YSTAL|IT)|MERGE|ST|TS|D)?|OOK(?:STORE|CRIT))|T(?:(?:EXTBOO|XTB)KS|BK)|O(?:LDBOO|B)K|NB(?:OOK)?)|ikipedia:Notability (books))\b)
Wikipedia:Events	Notability	(?:\bW(?:P:(?:(?:(?:CONTINUED)?COVERAG|PERSISTENC|GEOSCOP)E|N(?:E(?:WSEVENT|VENTS )|CRIME|NEWS|(E)|/CA)|D(?:E(?:LAY|PTH)|OGBITESMAN|IVERSE)|E(?:VENT(?:CRIT(?:ERIA)?)?|FFECT)|(?:BREAK|LAST)ING|R(?:OUTINE|APID)|ANTICIPATION|SENSATIONAL|INDEPTH)|ikipedia:Notability (events))\b)
Wikipedia:Films	Notability	(?:\bW(?:P:(?:N(?:F(?:[FP]|SOURCES|ILM|OE?)?|OTFILM)|FILMNOT|MOVIE )|ikipedia:Notability (films))\b)
Wikipedia:Geographic features	Notability	(?:\bW(?:P:(?:N(?:GEO(?:G(?:RAPHY)?)?|BUILD(?:ING)?|FEAT)|GEO(?:(?:LAN|ROA)D|FEAT|PURP))|ikipedia:Notability (geographic features))\b)
Wikipedia:Media	Notability	(?:\bW(?:P:(?:N(?:ME(?:DIA)?|TV)|TVS(?:ERIES|HOW)|B(?:ROAD)?CAST|STUDENTMEDIA|RPRGM)|ikipedia:Notability (media))\b)
Wikipedia:Music	Notability	(?:\bW(?:P:(?:N(?:S(?:INGLE|ONG)|M(?:USIC|G)?|ALBUMS?|CONCERT|TOUR)|S(?:INGER|UBNOT)|FUTUREALBUMS?|COMPOSER|MUSICBIO|BAND)|ikipedia:Notability (music))\b)
Wikipedia:Numbers	Notability	(?:\bW(?:ikipedia:Notability (numbers)|P:(?:NUMBER|WINI))\b)
Wikipedia:Organizations and companies	Notability	(?:\bW(?:P:(?:N(?:(?:ONPROFI|PRODUC)T|C(?:HURCH|ORP)|H?SCHOOL|GO)|C(?:O(?:RP(?:DEPTH)?|MPANY )|HAIN|LUB)|ORG(?:CRITE?|DEPTH|IND?|SIG)?|I(?:NHERITORG|LLCON)|FAIL(?:CORP|ORG)|PRODUCT(?:REV)?|A(?:DPROMO|UD)|MULTSOURCES|BRANCH|LISTED|GROUP)|ikipedia:Notability (organizations and companies))\b)
Wikipedia:People	Notability	(?:\bW(?:P:(?:B(?:LP(?:RELATED|FAMILY|NOTE )|IO(?:RELATED|FAMILY|1E)?|ASIC)|P(?:E(?:R(?:P(?:ETRATOR)?|SON)|OPLE)|O(?:LITICIAN|ET))|A(?:R(?:CHITEC|TIS)T|NYBIO|UTHOR)|E(?:NT(?:ERTAINER)?|CONOMIST)|N(?:(?:MODE|PO)L|ACTOR|BIO)|S(?:PORTSPERSON|INGLEEVENT)|CR(?:IM(?:INAL|E)?|EATIVE)|(?:FILMMAKE|DIRECTO)R|(?:INVALID|LIST)BIO|J(?:OURNALIST|UDGE)|ONEEVENT|VICTIM|1E)|ikipedia:Notability (people))\b)
Wikipedia:Sports	Notability	(?:\bW(?:P:(?:N(?:C(?:RIC(?:K(?:ET)?)?|URL(?:ING)?|YC(?:LING)?|OLLATH)|B(?:A(?:S(?:KETBALL|E)|D(?:MINTON)?)|OX(?:ING)?)|S(?:PORT(?:S(?:EVENT)?)?|EASONS|OCCER|KATE|UMO)|G(?:YMNAST(?:ICS)?|RIDIRON|AELIC|OLF)|H(?:O(?:RSERACING|CKEY|OPS)|SPHSATH)|T(?:R(?:IATHLON|ACK)|E(?:NNIS|AM))|R(?:IVALRY|ODEO|U)|M(?:OTORSPORT|MA)|FOOT(?:BALL|Y)|OLY(?:MPICS)?|A(?:FL|TH)|EQUESTRIAN|KICK)|(?:(?:BASE(?:BALL)?|CYC(?:LING)?|FIGURE|TENNIS|WPBB)/|RL/?)N|S(?:PORT(?:(?:SEVEN|CRI)T|BASIC)|KATER)|ATH(?:LETE)?|YOUNGATH)|ikipedia:Notability (sports))\b)
Wikipedia:Video games	Notability	(?:\bW(?:ikipedia:Notability (video games)|P:NV(?:IDEOGAMES|G))\b)
Wikipedia:Web	Notability	(?:\bW(?:P:(?:WEB(?:(?:PAG|SIT)E|NOTE |CRIT)?|(?:INHER(?:EN|I)T|N)WEB)|ikipedia:Notability (web))\b)
Wikipedia:Manual of Style	Style	(?:\bW(?:ikipedia:Manual of Style|P:MOS)\b)
Wikipedia:Dates and numbers	Style	(?:\bW(?:P:(?:M(?:OS(?:CONVERSIONS|NUM)|E(?:ASUREMENT|TRIC)|ILFORMAT)|CO(?:M(?:MONMATH|PUNITS)|ORDINATES)|UNIT(?:(?:(?:SYMBOL)?|NAME)S)?|D(?:ECIMAL|IGITS)|PERCENT|€|£|$|%)|ikipedia:Manual of Style/Dates and numbers)\b)
Wikipedia:Layout	Style	(?:\bW(?:P:(?:O(?:VERSECTION|RDER)|MOSLAYOUT)|ikipedia:Manual of Style/Layout)\b)
Wikipedia:Lead section	Style	(?:\bW(?:ikipedia:Manual of Style/Lead section|P:MOSLEAD)\b)
Wikipedia:Linking	Style	(?:\bW(?:ikipedia:Manual of Style/Linking|P:(?:DATE|TEST|YEAR|MOS)LINK)\b)
Wikipedia:Words to watch	Style	(?:\bW(?:P:(?:E(?:DITORIAL(?:IZING)?|UPHEMISM)|S(?:A(?:ID|Y)|URVIVEDBY)|P(?:EA(?:COCK)?|UFFERY)|W(?:HATPLACE|EASEL)|R(?:ELTIME|ACIST)|CL(?:ICHE|AIM)|(?:MOSWT|AW)W|FLOWERY|VULGAR|IDIOM|LABEL|OPED)|ikipedia:Manual of Style/Words to watch)\b)
Wikipedia:Accessibility	Style	(?:\bW(?:ikipedia:Manual of Style/Accessibility|P:(?:ACCESSIBILITY|RESOL))\b)
Wikipedia:Abbreviations	Style	(?:\bW(?:P:(?:ACRONYMTITLE|NCA(?:CRO)?|MOSABBR)|ikipedia:Manual of Style/Abbreviations)\b)
Wikipedia:Capital letters	Style	(?:\bW(?:P:(?:MOSC(?:APS|PT) |PROPERNAME|EXPABBR)|ikipedia:Manual of Style/Capital letters)\b)
Wikipedia:Pronunciation	Style	(?:\bW(?:ikipedia:Manual of Style/Pronunciation|P:MOSPRON)\b)
Wikipedia:Proper names	Style	(?:\bW(?:P:(?:MOSC(?:APS|PT) |PROPERNAME|EXPABBR)|ikipedia:Manual of Style/Capital letters)\b)
Wikipedia:Spelling	Style	(?:\bW(?:ikipedia:Manual of Style/Spelling|P:(?:SPELLING|MOSS|ISE))\b)
Wikipedia:Text formatting	Style	(?:\bW(?:ikipedia:Manual of Style/Text formatting|P:MOSTEXT)\b)
Wikipedia:Titles	Style	(?:\bW(?:ikipedia:Manual of Style/Titles|P:MOST(?:ITLE)?)\b)
Wikipedia:Tables	Style	(?:\bW(?:ikipedia:Manual of Style/Tables|P:(?:WHENTABLE|HEADERS))\b)
Wikipedia:Trivia sections	Style	(?:\bW(?:P:(?:MISC(?:ELLAN(?:EA|Y))?|TRIV(?:IA)?)|ikipedia:Manual of Style/Trivia sections)\b)
Wikipedia:Images	Style	(?:\bW(?:ikipedia:Manual of Style/Images|P:FIDUCIAL)\b)
Wikipedia:Captions	Style	(?:\bW(?:P:(?:CAP(?:CONTEXT|LENGTH|FRAG|TION|WORD)?|MAPOF)|ikipedia:Manual of Style/Captions)\b)
Wikipedia:Icons	Style	(?:\bW(?:P:(?:I(?:C(?:ONDECORATI)?ON|NFOBOXFLAG)|FLAG(?:PLACEHOLDER|CRUFT|BIO)|(?:APPROPRIATE|NO)ICONS|S(?:OVEREIGN|PORT)FLAG|MOS(?:FLAG|ICON|LOGO)|WORDPRECEDENCE|TOOMANY)|ikipedia:Manual of Style/Icons)\b)
Wikipedia:Lists	Style	(?:\bW(?:P:(?:(?:(?:(?:SOURC|DAT)E|FLAT|PURP|UB)LIS|BULLE(?:TLIS)?)T|L(?:EADFORALIST|ISTPURP)|CHRONO)|ikipedia:Manual of Style/Lists)\b)
Wikipedia:Embedded lists	Style	(?:\bW(?:P:(?:(?:(?:(?:SOURC|DAT)E|FLAT|PURP|UB)LIS|BULLE(?:TLIS)?)T|L(?:EADFORALIST|ISTPURP)|CHRONO)|ikipedia:Manual of Style/Lists)\b)
Wikipedia:Lists of works	Style	(?:\bW(?:P:(?:BIBLIOGRAPH(?:IES|Y)|MOS-BIBLIO|WORKS|LOW)|ikipedia:Manual of Style/Lists of works)\b)
Wikipedia:Road junction lists	Style	(?:\bW(?:ikipedia:Manual of Style/Road junction lists|P:RJL)\b)
Wikipedia:Stand-alone lists	Style	(?:\bW(?:P:(?:L(?:IST(?:C(?:RITERIA|OMPANY)|(?:GLOSSAR|VERIF)Y|(?:PEOPL|NAM)E|S?OFLISTS)|SC)|S(?:AL(?:ORDER|LEAD|AT)?|TAND(?:ALONE)?)|NC(?:LIST|SAL)|EXEMPT1E|CSC)|ikipedia:Stand-alone lists)\b)
Wikipedia:Biographies	Style	(?:\bW(?:ikipedia:Manual of Style/Biography|P:MOSBIO)\b)
Wikipedia:Article message boxes	Style	(?:\bWikipedia:Manual of Style/Article message boxes\b)
Wikipedia:Disambiguation pages	Style	(?:\bW(?:ikipedia:Manual of Style/Disambiguation pages|P:MOSDAB)\b)
Wikipedia:Infoboxes	Style	(?:\bW(?:P:I(?:NFOBOX(?:ETH(?:NICITY)?|(?:IMAG|CIT)E|GEO|REF)|BI)|ikipedia:Manual of Style/Infoboxes)\b)
Wikipedia:Self-references to avoid	Style	(?:\bW(?:ikipedia:Manual of Style/Self-references to avoid|P:(?:S(?:UBJECT|ELF|RTA)|CLICKHERE|ITSELF|WAWI))\b)
Wikipedia:Anime- and manga-related articles	Style	(?:\bW(?:ikipedia:Manual of Style/Anime- and manga-related articles|P:MOS-AM)\b)
Wikipedia:Comics	Style	(?:\bW(?:P:(?:C(?:MOS(?:#(?:S(?:TRUCTURE(?:-(?:(?:FICTIONALOBJ|SECTIONTITLE|CHARACTER|TEAM)S|PUBLICATION))?|PECIFIC|OURCES)|L(?:S(?:(?:PLI|OR)T|ECTION)|ISTS|NAME|F)|(?:C(?:IT(?:ESTYL)?|ATNAM|O)|BOXIMAG)E|P(?:RECISE|LOT|OP)|I(?:NFOBOX|SH)|N(?:ESTED|AME)|T(?:ITLES|EAM)))?|OMICS?PLOT)|OHOTMU)|ikipedia:Manual of Style/Comics)\b)
Wikipedia:Film	Style	(?:\bW(?:P:(?:FILM(?:(?:(?:C(?:RITICLI|A)|HI)S|PLO)T|M(?:ARKETING|USIC)|(?:RATIN|FLA)G|LE(?:AD|DE)|SC(?:ORE|I)|DIFF|YEAR|NFI)|(?:(?:(?:DEUTER|ANT)AGON|CASTL)IS|P(?:ROTAGONIS|LOTBLOA))T|T(?:R(?:ITAGONIST|AILER)|AGLINE)|MO(?:VIEPLOTS|SFILM)|YEARSINFILM)|ikipedia:Manual of Style/Film)\b)
Wikipedia:Lyrics and poetry	Style	(?:\bW(?:ikipedia:Lyrics and poetry|P:LYRICS)\b)
Wikipedia:Novels	Style	(?:\bW(?:P:(?:NOV(?:ELPLOT|STY)|MOS-NOVELS)|ikipedia:Manual of Style/Novels)\b)
Wikipedia:Philosophy	Style	(?:\bW(?:ikipedia:Manual of Style/Philosophy|P:PHILMOS)\b)
Wikipedia:Television	Style	(?:\bW(?:ikipedia:Manual of Style/Television|P:MOSTV)\b)
Wikipedia:Visual arts	Style	(?:\bW(?:ikipedia:Manual of Style/Visual arts|P:VAMOS)\b)
Wikipedia:Writing about fiction	Style	(?:\bW(?:ikipedia:Manual of Style/Writing about fiction|P:(?:BOOKPLOT|UNIVERSE))\b)
Wikipedia:Music	Style	(?:\bW(?:P:M(?:OS(?:MUSIC(?:CAPS)?|SOPHOMORE|LYRICS)|USORG)|ikipedia:Manual of Style/Music)\b)
Wikipedia:Music samples	Style	(?:\bW(?:ikipedia:Manual of Style/Music samples|P:SAMPLE)\b)
Wikipedia:Record charts	Style	(?:\bW(?:ikipedia:Manual of Style/Record charts|P:MUSIC/(?:CHARTS|TABLE))\b)
Wikipedia:Stringed instrument tunings	Style	(?:\bW(?:ikipedia:Manual of Style/Stringed instrument tunings|P:MOSTUNINGS)\b)
Wikipedia:Legal	Style	(?:\bW(?:ikipedia:Manual of Style/Legal|P:L(?:EGAL|AW)MOS)\b)
Wikipedia:Trademarks	Style	(?:\bW(?:ikipedia:Manual of Style/Trademarks|P:MOSTM)\b)
Wikipedia:Canada	Style	(?:\bW(?:P:(?:CAN(?:P(?:O[LP]|LACE|RIVY)|FRENCH|STYLE|CAN)|(?:THEYUKO|MOSCA)N)|ikipedia:Manual of Style/Canada-related articles)\b)
Wikipedia:China	Style	(?:\bW(?:ikipedia:Manual of Style/China and Chinese-related articles|P:(?:N(?:OCHINESEITALICS|C-CN)|CHINESECHARACTERS|PINYIN))\b)
Wikipedia:France	Style	(?:\bW(?:ikipedia:Manual of Style/France and French-related articles|P:(?:FRENCHNAMES|MOSFR))\b)
Wikipedia:Hawaii	Style	(?:\bW(?:ikipedia:Manual of Style/Hawaii-related articles|P:MOSHAWAII)\b)
Wikipedia:India	Style	(?:\bW(?:ikipedia:Manual of Style/India-related articles|P:(?:INDICSCRIPTS?|NOINDICSCRIPT|MOSI[NS]))\b)
Wikipedia:Ireland	Style	(?:\bW(?:P:(?:I(?:R(?:ISH FLAGS|E-IRL)|MO(?:S FLAG)?S)|(?:L(?:ONDON)?)?DERRY)|ikipedia:Manual of Style/Ireland-related articles)\b)
Wikipedia:Japan	Style	(?:\bW(?:ikipedia:Manual of Style/Japan-related articles|P:(?:J(?:A?TITL|PPLAC)E|M(?:OS-JA|J)|ROMAJI))\b)
Wikipedia:Korea	Style	(?:\bW(?:ikipedia:Manual of Style/Korea-related articles|P:MOS(?:KOREA|-KO))\b)
Wikipedia:Philippines	Style	(?:\bW(?:ikipedia:Manual of Style/Philippine-related articles|P:MOSPHIL)\b)
Wikipedia:Poland	Style	(?:\bW(?:ikipedia:Manual of Style/Poland-related articles|P:MOSPOL)\b)
Wikipedia:Singapore	Style	(?:\bW(?:ikipedia:Manual of Style/Singapore-related articles|P:MOS(?:DATESGP|SG))\b)
Wikipedia:Trinidad and Tobago	Style	(?:\bW(?:ikipedia:Trinidad and Tobago Wikipedians|P:TTS(?:TYLE|G))\b)
Wikipedia:Islam-related articles	Style	(?:\bW(?:ikipedia:Manual of Style/Islam-related articles|P:MOSISLAM)\b)
Wikipedia:Latter Day Saints	Style	(?:\bW(?:ikipedia:Manual of Style/Latter Day Saints|P:(?:LDS(?:JARGON|MOS)|MORMON))\b)
Wikipedia:WikiProject Computer science	Style	(?:\bWikipedia:WikiProject Computer science/Manual of style\b)
Wikipedia:Computing	Style	(?:\bW(?:ikipedia:Manual of Style/Computing|P:(?:COMPNOW|MOSCOMM))\b)
Wikipedia:Chemistry	Style	(?:\bW(?:ikipedia:Manual of Style/Chemistry|P:(?:(?:MOS|N)CHEM|CHEMMOS))\b)
Wikipedia:Mathematics	Style	(?:\bW(?:ikipedia:Manual of Style/Mathematics|P:(?:MSM|⋅))\b)
Wikipedia:Medicine-related articles	Style	(?:\bW(?:P:(?:M(?:ED(?:(?:SECTION|MO)S|C(?:ASE|OPY)|LE(?:AD|DE)|TRIVIA|ORDER|PRICE|REF)|OSMED)|(?:CITE|NC)MED)|ikipedia:Manual of Style/Medicine-related articles)\b)
Wikipedia:Taxobox template	Style	(?:\bWP:T(?:AXO(?:BOX)?|X)\b)
Wikipedia:Cue sports	Style	(?:\bW(?:ikipedia:Manual of Style/Cue sports|P:(?:CUEMOS|MOSCUE))\b)
Wikipedia:Snooker	Style	(?:\bW(?:P:(?:SNOOKER/(?:MOS|NF)|LIVESCORES|MOSSNOOKER)|ikipedia:Manual of Style/Snooker)\b)
Wikipedia:Scientific citation guidelines	See also	(?:\bW(?:ikipedia:Scientific citation guidelines|P:SC(?:ICITE|G))\b)
Wikipedia:Artist's impressions of astronomical objects	See also	(?:\bW(?:P:(?:ASTR|EX)OART|ikipedia:Artist)\b)
Wikipedia:In the news/Recurring items	See also	(?:\bW(?:ikipedia:In the news/Recurring items|P:ITN(?:(?:AWARD|SPORT)S|R))\b)
Wikipedia:Identifying reliable sources (medicine)	See also	(?:\bW(?:P:(?:M(?:ED(?:A(?:NIMAL|SSESS)|S(?:EARCH|CI)|B(?:IAS|OOK)|D(?:ATE|EF)|P(?:OP|RI)|R(?:EV|S)|INDY|COI|ORG)|BIAS)|(?:(?:DONTSHOUT|FUTON)BIA|HEALTHR)S|NO(?:TONLYFREE|ABSTRACT)|RSMED)|ikipedia:Identifying reliable sources (medicine))\b)
Wikipedia:Indic transliteration	See also	(?:\bWikipedia:Indic transliteration\b)
Wikipedia:Non-free use rationale guideline	See also	(?:\bW(?:ikipedia:Non-free use rationale guideline|P:(?:FU(?:RG?|G )|NFURG|RAT))\b)
Wikipedia:Public domain	See also	(?:\bW(?:P:(?:C(?:rown(?: copy(?:right)?|copy)|OPYEXP)|PD)|ikipedia:Public domain)\b)
Wikipedia:WikiProject Economics/Reliable sources and weight	See also	(?:\bW(?:ikipedia:WikiProject Economics/Reliable sources and weight|P:ECON(?:/RS|RSW))\b)
Wikipedia:Shortcut	See also	(?:\bW(?:P:(?:S(?:C(?:JARGON|NAMES)?|HORT)|LINKBOXES|CHANGESC)|ikipedia:Shortcut)\b)
Wikipedia:Project namespace	See also	(?:\bW(?:P:(?:P(?:R(?:J(?:C(?:RE)?|DEL|SD)?|O(?:CE)?PAGES)|(?:OLICYP)?AGES)|(?:H(?:OWTO|IS)|ESSAY|MAINT|INFO|DIS)PAGES|SUPPLEMENTAL|NS4)|ikipedia:Project namespace)\b)
Wikipedia:Reference desk/Guidelines/Medical advice	See also	(?:\bW(?:ikipedia:Reference desk/Guidelines/Medical advice|P:RD/G/M)\b)
Wikipedia:Talk page templates	See also	(?:\bWikipedia:Talk page templates\b)
Wikipedia:Userboxes	See also	(?:\bW(?:P:(?:U(?:SERBOX(?:C(?:REATE|AT))?|B(?:X(?:CREATE|NS)?|CR))|CREATEU(?:SERBO|B)X)|ikipedia:Userboxes)\b)
Wikipedia:Template namespace	See also	(?:\bW(?:P:(?:T(?:(?:MP)?G|PN)|NS10)|ikipedia:Template namespace)\b)
Wikipedia:Miscellany for deletion/Speedy redirect	See also	(?:\bW(?:ikipedia:Miscellany for deletion/Speedy redirect|P:(?:MFD/SRE?|SRE))\b)
Wikipedia:As of	See also	(?:\bW(?:P:(?:PRECISELANG|A(?:SOF|O))|ikipedia:As of)\b)
Wikipedia:Extended image syntax	See also	(?:\bW(?:ikipedia:Extended image syntax|P:(?:PICSIZE|EIS))\b)
Wikipedia:Disambiguation/PrimaryTopicDefinition	See also	(?:\bWikipedia:Disambiguation/PrimaryTopicDefinition\b)
Wikipedia:Overcategorization/User categories	See also	(?:\bW(?:ikipedia:Overcategorization/User categories|P:(?:USERCAT(?:YES|NO)|OC/U))\b)
Wikipedia:Spellchecking	See also	(?:\bW(?:ikipedia:Spellchecking|P:SPELL(?:CHECK)?)\b)
Wikipedia:TemplateStyles	See also	(?:\bWikipedia:TemplateStyles\b)
Wikipedia:Template namespace	See also	(?:\bW(?:P:(?:T(?:(?:MP)?G|PN)|NS10)|ikipedia:Template namespace)\b)
Wikipedia:Wikimedia sister projects	See also	(?:\bW(?:P:(?:S(?:IS(?:TER|P)?|OFTSISP)|MOSSIS)|ikipedia:Wikimedia sister projects)\b)
Wikipedia:WikiProject Council/Guide	See also	(?:\bW(?:P:(?:PROJ(?:GUIDE(?:#OWN)?|(?:SCOP|PAG)E)|(?:ADVICEPAG|REVIV)E|INACTIVEWP|COUNCIL/G|SCOPEWAR)|ikipedia:WikiProject Council/Guide)\b)
Wikipedia:Manual of Style/Hidden text	See also	(?:\bW(?:ikipedia:Manual of Style/Hidden text|P:(?:INVISIBLE|HIDDEN))\b)
Wikipedia:Manual of Style/Military history	See also	(?:\bW(?:P:(?:MIL(?:MOS(?:#(?:C(?:O(?:DE(?:STYL|NAM)E|NFLICTS)|A(?:MPAIGNS|TNAME)|IT(?:ESTYL)?E)|B(?:A(?:TTLES(?:IN)?|SENAME)|PROJ)|N(?:A(?:V(?:PROBLEMS)?|ME)|ESTED)|S(?:PECIFIC|ECTLEN|OURCES)|(?:OPCAT|FLAG|TANK|WAR)S|IN(?:TERSECTION|FOBOX)|(?:DATERANG|PRECIS)E|UNIT(?:NAME|S)|APP))?|(?:(?:CI|DA)T|NAM)E|S(?:OURCE|G)|APP)|SHIPPRONOUNS|CAMPAIGN)|ikipedia:Manual of Style/Military history)\b)
Wikipedia:Manual of Style/Indonesia-related articles	See also	(?:\bW(?:ikipedia:Manual of Style/Indonesia-related articles|P:ID-(?:N(?:AME|C)|SPELLING))\b)
Wikipedia:Manual of Style/Pakistan-related articles	See also	(?:\bW(?:ikipedia:Manual of Style/Pakistan-related articles|P:(?:URDUSCRIPT|NASTALIQ|MOSPA?K))\b)
Wikipedia:Manual of Style/Blazon	See also	(?:\bW(?:ikipedia:Manual of Style/Blazon|P:BL(?:AZON|Z))\b)
Wikipedia:Edit filter	See also	(?:\bW(?:P:(?:EF(?:M(?:AILING)?)?|(?:PRIVATE)?FILTER|AF)|ikipedia:Edit filter)\b)
Wikipedia:Naming conventions (US stations)	See also	(?:\bW(?:ikipedia:Naming conventions (US stations)|P:USSTATION)\b)
Wikipedia:Naming conventions (Irish stations)	See also	(?:\bW(?:ikipedia:Naming conventions (Irish stations)|P:IRLSTATION)\b)
Wikipedia:Naming conventions (Canadian stations)	See also	(?:\bW(?:ikipedia:Naming conventions (Canadian stations)|P:CANSTATION)\b)
Wikipedia:Naming conventions (places in Bangladesh)	See also	(?:\bW(?:ikipedia:Naming conventions (places in Bangladesh)|P:BDPLACE)\b)
Wikipedia:Naming conventions (Football in Australia)	See also	(?:\bW(?:ikipedia:Naming conventions (Football in Australia)|P:(?:MOSFI|NCFI?)A)\b)
Wikipedia:Five pillars	See also	(?:\b(?:W(?:ikipedia:Five Pillars|P:(?:PILLARS|5P))|w.wiki/5)\b)
