Assume good faith	Behavioral	(?:\bW(?:P:(?:G(?:OODFAITH|F)|A(?:GFC?|OBF)|FAITH|DGF)|ikipedia:Assume good faith))
Conflict of interest	Behavioral	(?:\bW(?:P:(?:C(?:O(?:I(?:(?:A(?:TTRIBUT|DVIC)|RESPONS)E|C(?:O(?:PYRIGHT|IN)|AMPAIGN)|P(?:AYDISCLOSE|OLITICAL)| is not simply bias|DISCLOSEPAY|NOTBIAS|LEGAL|EDIT|SELF|TALK|BLP|U)?|(?:NFLIC|VER)T)|URATOR)|P(?:A(?:ID(?:ATTRIBUTE|COPYRIGHT)|Y(?:TALK)?)|OTENTIALCOI|E)|(?:A(?:PPARENT|CTUAL)|F)COI|(?:SELF(?:PROMO|CI)T|UP)E|NO(?:HIDDENADS|P(?:AY|R))|D(?:ISCLOSE|COI)|EXTERNALREL|Open a COIN|LUC)|ikipedia:Conflict of interest))
Disruptive editing	Behavioral	(?:\bW(?:P:(?:D(?:IS(?:RUPT(?:SIGNS)?)?|(?:AP|D)?E|ONTGETIT)|I(?:D(?:IDNTHEARTHA|H)T|CANTHEARYOU)|NOTGETTINGIT|RUNAWAY|CTDAPE|LISTEN|HUH?)|ikipedia:Disruptive editing))
Do not disrupt Wikipedia to illustrate a point	Behavioral	(?:\bW(?:ikipedia:Do not disrupt Wikipedia to illustrate a point|P:(?:NOTPOINTy|POINTy?)))
Etiquette	Behavioral	(?:\bW(?:P:(?:AVOIDABUSE|E(?:TI)?Q|INDCRIT|DOOR|WQT?)|ikipedia:Etiquette))
Please do not bite the newcomers	Behavioral	(?:\bW(?:ikipedia:Please do not bite the newcomers|P:(?:N(?:EWBIES|OOB)|(?:BIT|IJM)E|DBN)))
Signatures	Behavioral	(?:\bW(?:P:(?:S(?:IG(?:#(?:N(?:[LT]|o(?:Templates|n-Latin|CAT))|CustomSig|[DE]L)|L(?:EN(?:GTH)?|INK)|N(?:(?:ATU|HE)RE)?|FO(?:RGE|NT)|IMAGE|PROB|APP|HOW)?|ignature forgery)|(?:(?:[345]|FOUR)TILDE|NL)S|Appearance and color|CUSTOMSIG|UNSIGNED|TILDE|~)|ikipedia:Signatures))
Talk page guidelines	Behavioral	(?:\bW(?:P:(?:T(?:ALK(?:#(?:(?:C(?:OMMUNIC|RE)AT|OBJECTIV|US)E|(?:DISCUS|FACT)S|NOMETA)|C(?:ENT|OND)|N(?:EW|O)|O)?|P(?:G(?:#YES)?|OC?|YES|NO)|OPPOST)|(?:(?:BOTTOM|CROSS-)PO|EXHAU)ST|(?:ARCHIVENOTDELET|INTERSPERS)E|S(?:HOUT(?:ING)?|PEAKENGLISH)|REDACT(?:ED)?|OWNTALK|MULTI)|ikipedia:Talk page guidelines))
User pages	Behavioral	(?:\bW(?:P:(?:U(?:P(?:#(?:P(?:RO(?:TECT|MO)|OLEMIC)|DEL(?:TALK|ETE)|NOT(?:SUITED)?|C(?:OPIES|MT)|G(?:AME|OAL)S|OWN|SUB)|GOOD|NOT|YES)?|SER(?:(?:SUB)?PAGE|TALKBLOG|BIO)?|OWN)|S(?:TALE(?:DRAFT)?|MI)|(?:FAKEARTICL|ORANG)E|N(?:EWMESSAGE|OBAN)|CREATEUSER#SUB|BLANKING|DELTALK|POLEMIC|REMOVED)|ikipedia:User pages))
Appealing a block	Behavioral	(?:\bW(?:P:(?:A(?:P(?:PEAL|B)|AB)|UNBLOCK)|ikipedia:Appealing a block))
Canvassing	Behavioral	(?:\bW(?:P:(?:VOTESTACK(?:ING)?|CAN(?:VAS)?|APPNOTE|STEALTH)|ikipedia:Canvassing))
Changing username	Behavioral	(?:\bW(?:ikipedia:Changing username/Guidelines|P:CHUG))
Courtesy vanishing	Behavioral	(?:\bW(?:P:(?:VANISH(?:ED )?|CV(?:AN|UT)|LEAVE|RTV)|ikipedia:Courtesy vanishing))
Deceased Wikipedians guidelines	Behavioral	(?:\bW(?:ikipedia:Deceased Wikipedians/Guidelines|P:DWG))
Gaming the system	Behavioral	(?:\bW(?:P:(?:S(?:ANCTIONGAM(?:ING|E)|PURIOUSPROTECT|TONEWALL)|GA(?:M(?:(?:ETYP)?E|ING)|SLIGHT(?:ING)?)|F(?:ORCEDINTERPRET|ILIBUSTER)|ONEHANDGIVES|PLAYPOLICY)|ikipedia:Gaming the system))
Linking to external harassment	Behavioral	(?:\bW(?:ikipedia:Linking to external harassment|P:LINKLOVE))
Responding to threats of harm	Behavioral	(?:\bW(?:P:(?:(?:VIOLENC|SUICID)E|EMERGENCY|URGENT|911 )|ikipedia:Responding to threats of harm))
Reviewing pending changes	Behavioral	(?:\bW(?:ikipedia:Reviewing pending changes|P:RPC))
Rollback	Behavioral	(?:\bW(?:P:R(?:OLL(?:BACK(?:USE)?)?|BK)|ikipedia:Rollback))
Spam blacklist	Behavioral	(?:\bW(?:ikipedia:Spam blacklist|P:(?:BLACKLIST|SPB)))
Autobiography	Content guide	(?:\bW(?:P:(?:A(?:UTO(?:#IFEXIST|BIOG?|PROB)?|B)|YOURSELF)|ikipedia:Autobiography))
Citing sources	Content guide	(?:\bW(?:P:(?:I(?:N(?:LINEC(?:ITE(?:CLUTTER)?|LUTTER)|TE(?:GRITY|XT)|DICATEAVAIL|CITE)|LCLUTTER|BID)|C(?:ITE(?:(?:BUNDL|TYP)E|S(?:HORT|TYLE)|CONSENSUS|FOOT|HOW|VAR|WEB)?|S)|S(?:AYWHERE(?:YOU(?:READ|GOT)IT)?|OURCELINKS|WY[GR]T|FN)|(?:WH(?:EN(?:NOTCIT|INROM)|YCIT)|(?:HOW|NO)CIT)E|B(?:OOKLINKS|UNDLING|LPCITE)|D(?:UPCITES|EADREF)|PAGE(?:LINKS|NUM)|G(?:BOOKS|ENREF)|ASL|REF)|ikipedia:Citing sources))
Content forking	Content guide	(?:\bW(?:P:(?:C(?:ONTENTFORK(?:ING)?|FORK)|RE(?:DUNDANTFORK|LART?)|POV(?:SPLIT|FORK)|S(?:PINOFF|UBPOV))|ikipedia:Content forking))
External links	Content guide	(?:\bW(?:P:(?:E(?:L(?:M(?:IN(?:OFFICIAL)?|AYBE)|B(?:URDEN|LP)|PO(?:INTS|V)|D(?:EAD|UP)|N(?:EVER|O)|R(?:EG|C)|T(?:EMP)?|OFFICIAL|#ADV|CITE|LIST|YES|WD)?|XT)|(?:COPYVIO|NONENG)EL|Y(?:OUTUBE|T)|LINKSTOAVOID|RICHMEDIA|ADV)|ikipedia:External links))
Fringe theories	Content guide	(?:\bW(?:P:(?:F(?:R(?:IN(?:GE(?:LEVEL|/PS|BLP)?|D)|NG)|DESC)|(?:EVAL|BLP|N)FRINGE|P(?:ROFRINGE|ARITY)|ONEWAY|DESCF|ITA)|ikipedia:Fringe theories))
Images	Content guide	(?:\bW(?:P:(?:PICTURES?|IMAGES?)|ikipedia:Images))
No disclaimers in articles	Content guide	(?:\bW(?:P:(?:N(?:ODISCLAIMERS|D[AT])|DISCLAIM)|ikipedia:No disclaimers in articles))
Non-free content	Content guide	(?:\bW(?:P:(?:N(?:F(?:C(?:[IP]|#(?:UU(?:LP|I)|CS)|C(?:EG?|P))?|LISTS|TABLE|EXMP|G)|ONFREE)|I(?:mage resolution|MAGERES)|F(?:AIRUSE |REER)?|TOP100|GETTY)|ikipedia:Non-free content))
Plagiarism	Content guide	(?:\bW(?:P:(?:(?:FREECOPYIN|NONENGPLA)G|PLAG(?:FORMS?|IARISM)?)|ikipedia:Plagiarism))
Reliable sources	Content guide	(?:\bW(?:P:(?:R(?:S(?:/(?:[AM]C|SPS)|BREAKING|CONTEXT|OPINION|PRIMARY| AGE|SELF)?|EL(?:IAB(?:ILITY|LE)|Y))|S(?:CHOLARSHIP|OURCETYPES|ELFSOURCE|PONSORED)|U(?:SE(?:RG(?:ENERATED)?|BYOTHERS)|BO|GC)|(?:CONTEXTMATTE|WPNOT)RS|A(?:GE MATTERS|FFILIATE)|P(?:UBLISHED|ARTISAN)|QUESTION(?:ABLE|ED)|BIASED(?:SOURCES)?|NEWSORG)|ikipedia:Reliable sources))
Spoiler	Content guide	(?:\bW(?:P:(?:S(?:POIL(?:ER(?:ALERT)?)?|W )|PREVIEWS)|ikipedia:Spoiler))
Wikipedia is not for things made up one day	Content guide	(?:\bW(?:ikipedia:Wikipedia is not for things made up one day|P:(?:N(?:OTMADEUP|FT)|SCRABBLE|MADEUP|ONEDAY|1DAY )))
Accuracy dispute	Content guide	(?:\bW(?:P:(?:D(?:ISPUTED|UBIOUS)|AD)|ikipedia:Accuracy dispute))
Anarchism referencing guidelines	Content guide	(?:\bW(?:P:A(?:N(?: OPINION|CITE)|LL ANARCHISTS|RGH)|ikipedia:Anarchism referencing guidelines))
Do not create hoaxes	Content guide	(?:\bW(?:P:(?:D(?:(?:ONT|W)HOAX|NCH)|N(?:OHOAXES|HOAX)|HOAX)|ikipedia:Do not create hoaxes))
Do not include the full text of lengthy primary sources	Content guide	(?:\bW(?:ikipedia:Do not include the full text of lengthy primary sources|P:N(?:OFULLTEXT|PS)))
Logos	Content guide	(?:\bW(?:P:(?:BANDLOGO|LOGOS?)|ikipedia:Logos))
No 3D illustrations	Content guide	(?:\bW(?:ikipedia:No 3D illustrations|P:3D))
Non-U.S. copyrights	Content guide	(?:\bW(?:ikipedia:Non-U.S. copyrights|P:(?:NUSC|URAA)))
Offensive material	Content guide	(?:\bW(?:P:(?:(?:BOWDLERIZ|PROFAN)E|G(?:RATUITOUS|FFENSE)|F*\**|SHIT|OM)|ikipedia:Offensive material))
Patent nonsense	Content guide	(?:\bW(?:P:(?:P(?:ATENT|N)|NONSENSE)|ikipedia:Patent nonsense))
Portal guidelines	Content guide	(?:\bW(?:ikipedia:Portal/Guidelines|P:PO(?:RT)?G))
Spam	Content guide	(?:\bW(?:P:(?:SPAM(?:LINKS?|#LINK|BAIT|MER)?|A(?:D(?:MAS[KQ]|S)|RTSPAM)|(?:CITE|LINK|REF)SPAM|B(?:OOKSPAM|ROCHURE)|OTHERSPAM(?:EXISTS)?|EXTPROMO)|ikipedia:Spam))
Television Episodes	Content guide	(?:\bW(?:ikipedia:Television episodes|P:(?:EPISODE|TVEP)))
Record Charts	Content guide	(?:\bW(?:P:(?:(?:(?:B(?:ILLBOAR|A)|GOO)D|OKAY|US)CHARTS|SINGLE(?:NETWORK|VENDOR)|CHART(?:MATH|TRAJ)?)|ikipedia:Record charts))
WikiProject Days of the year articles	Content guide	(?:\bW(?:P:(?:D(?:O(?:Y(?:CITE)?|TY)|EATHDOY)|BIRTHDOY|NGS)|ikipedia:Days of the year))
Video games articles	Content guide	(?:\bW(?:P:(?:VG(?:/(?:P(?:O[PV]|LOT)|(?:MIXE|LEA)D|RE(?:LEASE|C)|DATE(?:CAT)?|CONTENT|NONENG|STYLE|EL|JP)|IMAGES|JARGON|LAYOUT|ORDER|SCOPE|BOX)|GAMECRUFT|MOSVG|JFN)|ikipedia:Manual of Style/Video games))
Deletion process	Deletion	(?:\bW(?:P:(?:D(?:PR(?:#(?:[ACFMRT]FD|DRV|NAC))?|ELPRO(?:#(?:[ACFMRT]FD|DRV))?)|(?:P(?:ROCEDURAL)?CLOS|BIGDELET)E|S(?:(?:OFTDELET|CLOS)E|EARCHDEL)|N(?:OQUORUM|ACD)|WITHDRAWN|RELIST|EARLY|XFD)|ikipedia:Deletion (?:proces|forum|venue)s))
Speedy keep	Deletion	(?:\bW(?:P:(?:SK(?:(?:#NO|CRI)T)?|KEEP|CSK)|ikipedia:Speedy keep))
Deletion guidelines for administrators	Deletion	(?:\bW(?:ikipedia:Deletion guidelines for administrators|P:(?:ROUGHCONSENSUS|DGFA)))
Article size	Editing	(?:\bW(?:P:(?:S(?:(?:UBARTIC|IZERU)LE|P(?:LITLIS|INOU)T)|(?:CHOKIN|TOOBI)G|(?:RP|A)S|LENGTH|HASTE)|ikipedia:Article size))
Be bold	Editing	(?:\bW(?:P:(?:B(?:OLD(?:NOTOBLIGATORY)?|NO|B)|(?:SO)?FIXIT|RECKLESS|CAREFUL|GLC)|ikipedia:Be bold))
Disambiguation	Editing	(?:\bW(?:P:(?:D(?:AB(?:N(?:O(?:INCLUDE|T)|AME)|A(?:CRONYM|BBREV)|CO(?:MBINE|NCEPT)|S(?:ISTER|TYLE)|DI(?:SPLAY|C)|RE(?:LATED|F)|LINKS?)?|ETERMINEPRIMARY|(?:OUBLE)?DAB|ISAMBIG|PAGES?|LINKS|BC)?|P(?:RIMARY(?:REDIRECT|TOPIC|USAGE)|T(?:OPIC|M)|ARTIAL)|IN(?:TDAB(?:LINK|S)?|C(?:OMP)?DAB)|N(?:OPRIMARY|AMELIST|WFCTM|CDAB)|F(?:IXDABLINKS|URTHERDAB)|T(?:(?:ITLE)?PTM|WODABS)|(?:CONCEPT|HOWTO)DAB|BUTIDONTKNOWABOUTIT|(?:MULTI|2)DABS|ONEOTHER)|ikipedia:(?:Disambiguation|PRIMARYRED)))
Technical articles	Editing	(?:\bW(?:P:(?:O(?:VERSIMPLIFY|NEDOWN)|TECH(?:-CONTENT|NICAL)|EXPLAINLEAD|UPFRONT|MTAU)|ikipedia:Make technical articles understandable))
Categories, lists, and navigation templates	Editing	(?:\bW(?:P:(?:BIDI(?:RECTIONAL)?|N(?:OTDUPE?|AVBOX)|(?:FILM|PERF)NAV|LINKBACK|AOA[CL]|DOA[CL]|SIDEBAR|CLNT?)|ikipedia:Categories, lists, and navigation templates))
Categorization	Editing	(?:\bW(?:P:(?:(?:T(?:EMPLATE|OPIC)?|HIDDEN|USERNO|FILE|MOS)CAT|C(?:AT(?:DEF(?:INING)?|V(?:ER)?|#[TV]|EGORY)?|G)|S(?:(?:U(?:PER|B)|ET)CAT|ORTKEY)|D(?:(?:RAFTNO|UP)CAT|IFFUSE)|EPON(?:YMOUS)?|PROJCATS)|ikipedia:Categorization))
Categorization of people	Editing	(?:\bW(?:P:(?:(?:(?:EPCATP|PE)ER|LISTA)S|COP(?:S(?:EP)?|DEF|#N|/S)?|S(?:EPARATE|UR)|NAMESORT|MCSTJR)|ikipedia:Categorization of people))
by year	Editing	(?:\bW(?:ikipedia:People by year|P:PBY))
by ethnicity, gender, religion and sexuality	Editing	(?:\bW(?:P:(?:CAT(?:/(?:EGRS|GRS |R)|G(?:ENDER|RS)|EGRS)|E(?:THNICRACECAT|GRS)|FINAL RUNG|GHETTO)|ikipedia:Categorization/Ethnicity, gender, religion and sexuality))
Redirect categories	Editing	(?:\bW(?:P:(?:(?:R(?:ED)?|LISTR)CAT|INCOMPATIBLE)|ikipedia:Categorizing redirects))
User categories	Editing	(?:\bW(?:P:U(?:SERCAT(?:YES|NO)?|CAT)|ikipedia:User categories))
Overcategorization	Editing	(?:\bW(?:P:(?:O(?:C(?:A(?:SSOC|WARD|T)|E(?:GRS|PON)|LOCATION|VENUE|MISC)?|(?:VER(?:LAP)?|PINION)CAT)|S(?:MALL(?:CAT)?|UBJECTIVECAT|HAREDNAME)|(?:ARBITRARY|CANDIDATE|PERF)CAT|N(?:ONDEF(?:INING)?|ARROWCAT)|T(?:RIVIALCAT|OPTEN))|ikipedia:Overcategorization))
Reviewing good articles	Editing	(?:\bW(?:ikipedia:Reviewing good articles|P:RGA))
Subpages	Editing	(?:\bW(?:P:(?:TITLESLASH|S(?:UB|P))|ikipedia:Subpages))
Copying within Wikipedia and Wikimedia	Editing	(?:\bW(?:P:(?:C(?:OPYWITHIN|WW)|ATT(?:REQ|SIT)|R(?:U[DU]|IA)|(?:NO|P)ATT|TFOLWP)|ikipedia:Copying within Wikipedia))
Hatnote use	Editing	(?:\bW(?:P:(?:H(?:AT(?:NOTE(?:PLACE|RULES)|EXTRA)?|N[PRS]?|RULES)|(?:(?:ONESHOR|LEGI)T|EL|TR|1)HAT|N(?:O(?:ARTICLE|TAMB)|AMB)|RE(?:LATED|DHAT)|SIMILAR)|ikipedia:Hatnote))
High-risk templates protection	Editing	(?:\bW(?:ikipedia:High-risk templates|P:H(?:IGHRISK|RT)))
Page blanking	Editing	(?:\bW(?:P:(?:PAGEBLANKING|BLANK)|ikipedia:Page blanking))
Preparing images for upload	Editing	(?:\bW(?:ikipedia:Preparing images for upload|P:(?:PIFU|USOP)))
Recent years	Editing	(?:\bW(?:ikipedia:Recent years|P:RY[BD]?))
Red links	Editing	(?:\bW(?:P:(?:RED(?:LINK(?:BIO|S)?|DEAL|NOT?|BIO|YES)?|CHECKAFTERCREATE|INCOMINGLINKS)|ikipedia:Red link))
Reference desk guidelines	Editing	(?:\bW(?:ikipedia:Reference desk/Guidelines|P:RD/G))
Substitution use	Editing	(?:\bW(?:P:(?:SUBST(?:(?:MUS|NO)T)?|TSUB)|ikipedia:Substitution))
Summary style	Editing	(?:\bW(?:P:(?:S(?:UMMARY|YNC|S)|AVOIDSPLIT|DETAIL)|ikipedia:Summary style))
Updating articles	Editing	(?:\bWikipedia:Updating information)
Version 1.0 Editorial Team assessment	Editing	(?:\bW(?:P:(?:(?:NONSTANDARDCLA|ASSE)SS|1.0/A)|ikipedia:Content assessment))
Broad concept articles	Editing	(?:\bW(?:P:(?:DABCON(?:G(?:AME|EO|OV)|P(?:HYS|ROD)|BRAND|SPORT|MATH|OFF)|B(?:ROAD(?:CONCEPT)?|CA))|ikipedia:Broad-concept article))
Recent year articles	Editing	(?:\bW(?:ikipedia:Recent years|P:RY[BD]?))
Stubs	Editing	(?:\bW(?:P:(?:S(?:TUB(?:S(?:PACING)?|DEF|IFY)?|VSP)|(?:IDEAL|NEW|TAG|DE)STUB|P(?:ROJSTUB|SA))|ikipedia:Stub))
Set index articles	Editing	(?:\bW(?:P:(?:S(?:ET(?:NOTDAB|INDEX)|IA(?:NOTDAB)?)|NOTDAB)|ikipedia:Set index articles))
Redirects	Editing	(?:\bW(?:P:(?:R(?:#(?:C(?:ATEGORY|RD)|ASTONISH|SUPPRESS|HARMFUL|DELETE|KEEP|PLA)|EDIR(?:ECTPROTECTION)?|P(?:ROTECTION|URPOSE)|NEUTRAL|SECT|TOA)?|B(?:LA(?:NKANDREDIRECT|R)|RINT)|N(?:AVNOREDIRECT|OTBROKEN)|(?:DONOTFIXI|TARGE)T|(?:SELF|ED)RED|POFR)|ikipedia:Redirect))
Soft redirects	Editing	(?:\bW(?:P:S(?:OFT(?:REDIR|TEMP)|RD)|ikipedia:Soft redirect))
Article titles	Naming conventions	(?:\bW(?:P:(?:N(?:A(?:M(?:INGCRITERIA|ECHANGES)|TURAL(?:NES|DI)S)|POV(?:TITL|NAM)E|DESC|OUN)|T(?:ITLE(?:(?:SPECIALCHARACTER|CHANGE)S|FORMAT|VAR|TM)?|RANSLITERATE|SC)|D(?:E(?:SCRIPDIS|FINITE)|IFF(?:PUNCT|CAPS))|P(?:OV(?:TITL|NAM)E|RECIS(?:ION|E)|ARENDIS)|C(?:O(?:MM(?:ONNAME|ADIS)|NCISE)|RITERIA)|(?:ITALICTITL|LOWERCAS)E|A(?:T(?:D(?:AB|IS))?|ND)|S(?:MALLDETAILS|INGULAR)|RECOGNIZABILITY|OTHERNAMES|U(?:CRN|E)|QUALIFIER|MOSAT)|ikipedia:Article titles))
Category names	Naming conventions	(?:\bW(?:ikipedia:Category names|P:(?:CATNAME|NCCAT)))
File names	Naming conventions	(?:\bW(?:P:F(?:M(?:V/W|NN)|ILENAMES|NC)|ikipedia:File names))
Naming conventions (acronyms)	Naming conventions	(?:\bW(?:P:(?:ACRONYMTITLE|NCA(?:CRO)?|MOSABBR)|ikipedia:Manual of Style/Abbreviations))
Naming conventions (capitalization)	Naming conventions	(?:\bW(?:ikipedia:Naming conventions (capitalization)|P:NCC(?:APS|PT)))
Naming conventions (country-specific topics)	Naming conventions	(?:\bW(?:ikipedia:Naming conventions (country-specific topics)|P:NCCST))
Naming conventions (definite or indefinite article at beginning of name)	Naming conventions	(?:\bW(?:ikipedia:Naming conventions (definite or indefinite article at beginning of name)|P:(?:NC(?:THE|AN)|THE(?:UNI)?)))
Naming conventions (events)	Naming conventions	(?:\bW(?:P:(?:N(?:CE(?:VENTS)?|OYEAR)|D(?:ESCRIPTO|ISASTE)R)|ikipedia:Naming conventions (events)))
Naming conventions (geographic names)	Naming conventions	(?:\bW(?:P:(?:N(?:C(?:P(?:LACE(?:DAB)?|HILIPPINE)|(?:FALKLA|I)ND|AUST|CS|GN)|BZ)|(?:S(?:COTLAND|RB)|U[KS]|VIET)PLACE|M(?:ODERNPLACENAME|PN)|PLACE(?:DAB)?|WIAN)|ikipedia:Naming conventions (geographic names)))
Naming conventions (numbers and dates)	Naming conventions	(?:\bW(?:P:(?:NC(?:D(?:URATION|ATES)|NUM)|DATERANGETITLES)|ikipedia:Naming conventions (numbers and dates)))
Naming conventions (long lists)	Naming conventions	(?:\bW(?:ikipedia:Naming conventions (long lists)|P:NC(?:L(?:ONGLIST|L)|SPLITLIST)))
Naming conventions (people)	Naming conventions	(?:\bW(?:P:(?:M(?:IDDL(?:ENAM)?E|ONONYM|AIDEN)|N(?:C(?:P(?:DAB)?|BIO)|ICKNAME)|S(?:(?:INGL|TAG)ENAME|PNC)|(?:TITLESINTITLE|INIT)S|PSEUDONYM|JR/SR)|ikipedia:Naming conventions (people)))
Naming conventions (plurals)	Naming conventions	(?:\bW(?:ikipedia:Naming conventions (plurals)|P:(?:PLURAL(?:PT)?|NCPLURAL)))
Naming conventions (technical restrictions)	Naming conventions	(?:\bW(?:P:(?:NC(?:-(?:COLONS?|SLASH)|LOWERCASEFIRST|HASHTAG|TR)|TITLELENGTH)|ikipedia:Naming conventions (technical restrictions)))
Naming conventions (use English)	Naming conventions	(?:\bW(?:P:(?:DI(?:ACRITICS|VIDEDUSE)|E(?:STABLISHED|NGLISH)|NCUE|UEIA)|ikipedia:Naming conventions (use English)))
Aircraft	Naming conventions	(?:\bW(?:ikipedia:Naming conventions (aircraft)|P:(?:NCAIR(?:CRAFT)?|AIR/NC)))
Ancient Romans	Naming conventions	(?:\bW(?:ikipedia:Naming conventions (ancient Romans)|P:(?:ROMANS|NCRN)))
Armenian	Naming conventions	(?:\bW(?:ikipedia:Naming conventions (Armenian)|P:(?:NCARME(?:NIA)?|ARME)N))
Astronomical objects	Naming conventions	(?:\bW(?:ikipedia:Naming conventions (astronomical objects)|P:(?:(?:PLANET|STAR)NAMES|NCASTRO)))
Australian roads	Naming conventions	(?:\bW(?:ikipedia:Naming conventions (Australian roads)|P:(?:AURDNAME|NCAURD)))
Baseball players	Naming conventions	(?:\bW(?:ikipedia:Naming conventions (baseball players)|P:NC-?BASE))
Belgium: castle, country house, château and kasteel	Naming conventions	(?:\bWikipedia:WikiProject Belgium/Castle, country house, château and kasteel naming conventions)
Belgium: alternate language names	Naming conventions	(?:\bWikipedia:WikiProject Belgium/Alternate language names)
Books	Naming conventions	(?:\bW(?:P:(?:NC(?:B(?:OOKS|K)?|-BK)|SUBTITLES?|BOOKDAB)|ikipedia:Naming conventions (books)))
Broadcasting	Naming conventions	(?:\bW(?:ikipedia:Naming conventions (broadcasting)|P:NC-?BC))
Brussels	Naming conventions	(?:\bWikipedia:WikiProject Belgium/Brussels naming conventions)
Burmese	Naming conventions	(?:\bW(?:ikipedia:Naming conventions (Burmese)|P:BURMESE))
Chemistry	Naming conventions	(?:\bW(?:P:(?:C(?:HEMNAME|AES)|(?:NCCHE|ALU)M|MOSCHEM/NAME|SULF)|ikipedia:Naming conventions (chemistry)))
Chinese	Naming conventions	(?:\bW(?:P:(?:NC-(?:CH(?:INA|N)|ZH)|(?:CHINES|ZHNAM)E)|ikipedia:Naming conventions (Chinese)))
Clergy	Naming conventions	(?:\bW(?:ikipedia:Naming conventions (clergy)|P:(?:NC(?:CL|WC)|BISHOP)))
College football	Naming conventions	(?:\bWikipedia:WikiProject College football/Naming conventions)
Comics	Naming conventions	(?:\bW(?:ikipedia:Naming conventions (comics)|P:NCC(?:OMICS|/THE|DAB)))
Companies	Naming conventions	(?:\bW(?:ikipedia:Naming conventions (companies)|P:NCCORP))
Ethnicities and tribes	Naming conventions	(?:\bW(?:ikipedia:Naming conventions (ethnicities and tribes)|P:(?:ETHNICGROUP|NCET(?:/A)?|TRIBE)))
Fauna	Naming conventions	(?:\bW(?:ikipedia:Naming conventions (fauna)|P:(?:(?:MONOTYPI|N)C)?FAUNA))
Films	Naming conventions	(?:\bW(?:ikipedia:Naming conventions (films)|P:(?:NCF(?:ILMS?)?|PRIMARYFILM)))
Flora	Naming conventions	(?:\bW(?:P:(?:NC(?:(cultivar)|FLORA)|(?:MONOTYPIC)?FLORA|CULTIVAR)|ikipedia:Naming conventions (flora)))
Geographic names	Naming conventions	(?:\bW(?:P:(?:N(?:C(?:P(?:LACE(?:DAB)?|HILIPPINE)|(?:FALKLA|I)ND|AUST|CS|GN)|BZ)|(?:S(?:COTLAND|RB)|U[KS]|VIET)PLACE|M(?:ODERNPLACENAME|PN)|PLACE(?:DAB)?|WIAN)|ikipedia:Naming conventions (geographic names)))
Government and legislation	Naming conventions	(?:\bW(?:ikipedia:Naming conventions (government and legislation)|P:NC(?:-(?:ELECT|GAL)|ELECT|GAL)))
Greek	Naming conventions	(?:\bW(?:ikipedia:Naming conventions (Greek)|P:(?:NC)?GREEK))
Hebrew	Naming conventions	(?:\bW(?:ikipedia:Naming conventions (Hebrew)|P:(?:NCHE(?:BREW)?|HE(?:BREW)?)))
Ice hockey	Naming conventions	(?:\bW(?:ikipedia:Naming conventions (ice hockey)|P:NCIH))
Indic	Naming conventions	(?:\bW(?:ikipedia:Naming conventions (Indic)|P:NCIN(?:DIC)?))
Irish categories	Naming conventions	(?:\bW(?:ikipedia:WikiProject Ireland/Ireland Category Norms|P:IRE-CATS))
Korean	Naming conventions	(?:\bW(?:ikipedia:Naming conventions (Korean)|P:NC(?:-(?:SoJ|KO)|KO(?:REAN)?)))
Languages	Naming conventions	(?:\bW(?:ikipedia:Naming conventions (languages)|P:(?:NCL(?:ANG)?|DIALECT)))
Law enforcement agency categories	Naming conventions	(?:\bW(?:ikipedia:Naming conventions (law enforcement agency categories)|P:LEAC(?:AT)?))
Latter Day Saints	Naming conventions	(?:\bW(?:ikipedia:Naming conventions (Latter Day Saints)|P:NCLDS))
Macedonia	Naming conventions	(?:\bW(?:ikipedia:Naming conventions (Macedonia)|P:(?:MOSMAC3?|NCMAC)))
Manuscripts	Naming conventions	(?:\bW(?:ikipedia:Naming conventions (manuscripts)|P:NCMANU(?:SCRIPT)?))
Mining	Naming conventions	(?:\bW(?:ikipedia:WikiProject Mining/Style guide|P:MINESTYLE))
Mongolian	Naming conventions	(?:\bW(?:ikipedia:Naming conventions (Mongolian)|P:(?:(?:NC)?MO|RM)N))
Music	Naming conventions	(?:\bW(?:P:(?:(?:S(?:INGER|ONG)|COMPOSITION|ALBUM|EP)DAB|BAND(?:NAME|DAB)|NCM(?:USIC|DAB)?|MUSICSERIES|DABSONG)|ikipedia:Naming conventions (music)))
New Zealand	Naming conventions	(?:\bW(?:ikipedia:Naming conventions (New Zealand)|P:NCNZ))
Norse mythology	Naming conventions	(?:\bW(?:ikipedia:Naming conventions (Norse mythology)|P:NCNM))
Operas	Naming conventions	(?:\bW(?:ikipedia:Naming conventions (operas)|P:NCO(?:PERA)?))
Political parties	Naming conventions	(?:\bW(?:ikipedia:Naming conventions (political parties)|P:NCP(?:ARTY|P)))
Royalty and nobility	Naming conventions	(?:\bW(?:P:(?:NC(?:(?:BRIT)?PEER|R(?:AN|OY)|N(?:OB|T))|CO(?:GNOMEN|NSORTS)|SOVEREIGN|OBE)|ikipedia:Naming conventions (royalty and nobility)))
Ships	Naming conventions	(?:\bW(?:P:(?:SH(?:IP(?:NAME|DAB)|E4SHIPS)|NC(?:S(?:HIP )?|-SHIPS?))|ikipedia:Naming conventions (ships)))
Sports teams	Naming conventions	(?:\bW(?:ikipedia:Naming conventions (sports teams)|P:NCST))
Sportspeople	Naming conventions	(?:\bW(?:ikipedia:Naming conventions (sportspeople)|P:NCSP))
Stations in Poland	Naming conventions	(?:\bW(?:ikipedia:Naming conventions (stations in Poland)|P:NC-PLSTATIONS))
Swiss municipalities	Naming conventions	(?:\bWikipedia:WikiProject Swiss municipalities/Article title conventions)
Television	Naming conventions	(?:\bW(?:P:(?:NC(?:TV(?:U[KS])?|[-:]TV)|TV(?:SEASON|-NC))|ikipedia:Naming conventions (television)))
Tibetan	Naming conventions	(?:\bW(?:ikipedia:Naming conventions (Tibetan)|P:NC-TIBET))
UK Parliament constituencies	Naming conventions	(?:\bWikipedia:Naming conventions (UK Parliament constituencies))
UK stations	Naming conventions	(?:\bW(?:ikipedia:Naming conventions (UK stations)|P:(?:UKSTATION(?:DAB)?|NCUKSTATIONS)))
US state and territory highways	Naming conventions	(?:\bW(?:ikipedia:Naming conventions (U.S. state and territory highways)|P:USSH))
Video games	Naming conventions	(?:\bW(?:ikipedia:Naming conventions (video games)|P:NC(?:GAMES(?:DAB)?|VG(?:DAB)?)))
West Bank	Naming conventions	(?:\bW(?:ikipedia:Naming conventions (West Bank)|P:(?:WESTBANK|NCWB|J&S)))
Writing systems	Naming conventions	(?:\bW(?:ikipedia:Naming conventions (writing systems)|P:NC(?:(WS)|WS)))
Notability	Notability	(?:\bW(?:P:(?:N(?:O(?:T(?:E(?:WORTHY|SAL)?|TEMPORARY)|PAGE)|LISTITEM|POSSIBLE|EXIST|RVE?|TEMP|NC?)?|(?:(?:CON|LIS|AR)T|FAIL|WHY)N|S(?:USTAINED|IGCOV|PIP)|PAGEDECIDE|15MOF|GNG)|ikipedia:Notability))
Academics	Notability	(?:\bW(?:P:(?:N(?:ACADEMIC|PROF)|ACADEMIC|TEACHER |SCHOLAR|PROF)|ikipedia:Notability (academics)))
Astronomical objects	Notability	(?:\bW(?:ikipedia:Notability (astronomical objects)|P:(?:NAST(?:CRIT|HELP|RO)|AST2000|DWMP)))
Books	Notability	(?:\bW(?:P:(?:B(?:K(?:CR(?:YSTAL|IT)|MERGE|ST|TS|D)?|OOK(?:STORE|CRIT))|T(?:(?:EXTBOO|XTB)KS|BK)|O(?:LDBOO|B)K|NB(?:OOK)?)|ikipedia:Notability (books)))
Events	Notability	(?:\bW(?:P:(?:(?:(?:CONTINUED)?COVERAG|PERSISTENC|GEOSCOP)E|N(?:E(?:WSEVENT|VENTS )|CRIME|NEWS|(E)|/CA)|D(?:E(?:LAY|PTH)|OGBITESMAN|IVERSE)|E(?:VENT(?:CRIT(?:ERIA)?)?|FFECT)|(?:BREAK|LAST)ING|R(?:OUTINE|APID)|ANTICIPATION|SENSATIONAL|INDEPTH)|ikipedia:Notability (events)))
Films	Notability	(?:\bW(?:P:(?:N(?:F(?:[FP]|SOURCES|ILM|OE?)?|OTFILM)|FILMNOT|MOVIE )|ikipedia:Notability (films)))
Geographic features	Notability	(?:\bW(?:P:(?:N(?:GEO(?:G(?:RAPHY)?)?|BUILD(?:ING)?|FEAT)|GEO(?:(?:LAN|ROA)D|FEAT|PURP))|ikipedia:Notability (geographic features)))
Media	Notability	(?:\bW(?:P:(?:N(?:ME(?:DIA)?|TV)|TVS(?:ERIES|HOW)|B(?:ROAD)?CAST|STUDENTMEDIA|RPRGM)|ikipedia:Notability (media)))
Music	Notability	(?:\bW(?:P:(?:N(?:S(?:INGLE|ONG)|M(?:USIC|G)?|ALBUMS?|CONCERT|TOUR)|S(?:INGER|UBNOT)|FUTUREALBUMS?|COMPOSER|MUSICBIO|BAND)|ikipedia:Notability (music)))
Numbers	Notability	(?:\bW(?:ikipedia:Notability (numbers)|P:(?:NUMBER|WINI)))
Organizations and companies	Notability	(?:\bW(?:P:(?:N(?:(?:ONPROFI|PRODUC)T|C(?:HURCH|ORP)|H?SCHOOL|GO)|C(?:O(?:RP(?:DEPTH)?|MPANY )|HAIN|LUB)|ORG(?:CRITE?|DEPTH|IND?|SIG)?|I(?:NHERITORG|LLCON)|FAIL(?:CORP|ORG)|PRODUCT(?:REV)?|A(?:DPROMO|UD)|MULTSOURCES|BRANCH|LISTED|GROUP)|ikipedia:Notability (organizations and companies)))
People	Notability	(?:\bW(?:P:(?:B(?:LP(?:RELATED|FAMILY|NOTE )|IO(?:RELATED|FAMILY|1E)?|ASIC)|P(?:E(?:R(?:P(?:ETRATOR)?|SON)|OPLE)|O(?:LITICIAN|ET))|A(?:R(?:CHITEC|TIS)T|NYBIO|UTHOR)|E(?:NT(?:ERTAINER)?|CONOMIST)|N(?:(?:MODE|PO)L|ACTOR|BIO)|S(?:PORTSPERSON|INGLEEVENT)|CR(?:IM(?:INAL|E)?|EATIVE)|(?:FILMMAKE|DIRECTO)R|(?:INVALID|LIST)BIO|J(?:OURNALIST|UDGE)|ONEEVENT|VICTIM|1E)|ikipedia:Notability (people)))
Sports	Notability	(?:\bW(?:P:(?:N(?:C(?:RIC(?:K(?:ET)?)?|URL(?:ING)?|YC(?:LING)?|OLLATH)|B(?:A(?:S(?:KETBALL|E)|D(?:MINTON)?)|OX(?:ING)?)|S(?:PORT(?:S(?:EVENT)?)?|EASONS|OCCER|KATE|UMO)|G(?:YMNAST(?:ICS)?|RIDIRON|AELIC|OLF)|H(?:O(?:RSERACING|CKEY|OPS)|SPHSATH)|T(?:R(?:IATHLON|ACK)|E(?:NNIS|AM))|R(?:IVALRY|ODEO|U)|M(?:OTORSPORT|MA)|FOOT(?:BALL|Y)|OLY(?:MPICS)?|A(?:FL|TH)|EQUESTRIAN|KICK)|(?:(?:BASE(?:BALL)?|CYC(?:LING)?|FIGURE|TENNIS|WPBB)/|RL/?)N|S(?:PORT(?:(?:SEVEN|CRI)T|BASIC)|KATER)|ATH(?:LETE)?|YOUNGATH)|ikipedia:Notability (sports)))
Video games	Notability	(?:\bW(?:ikipedia:Notability (video games)|P:NV(?:IDEOGAMES|G)))
Web	Notability	(?:\bW(?:P:(?:WEB(?:(?:PAG|SIT)E|NOTE |CRIT)?|(?:INHER(?:EN|I)T|N)WEB)|ikipedia:Notability (web)))
Manual of Style	Style	(?:\bW(?:ikipedia:Manual of Style|P:MOS))
Dates and numbers	Style	(?:\bW(?:P:(?:M(?:OS(?:CONVERSIONS|NUM)|E(?:ASUREMENT|TRIC)|ILFORMAT)|CO(?:M(?:MONMATH|PUNITS)|ORDINATES)|UNIT(?:(?:(?:SYMBOL)?|NAME)S)?|D(?:ECIMAL|IGITS)|PERCENT|€|£|$|%)|ikipedia:Manual of Style/Dates and numbers))
Layout	Style	(?:\bW(?:P:(?:O(?:VERSECTION|RDER)|MOSLAYOUT)|ikipedia:Manual of Style/Layout))
Lead section	Style	(?:\bW(?:ikipedia:Manual of Style/Lead section|P:MOSLEAD))
Linking	Style	(?:\bW(?:ikipedia:Manual of Style/Linking|P:(?:DATE|TEST|YEAR|MOS)LINK))
Words to watch	Style	(?:\bW(?:P:(?:E(?:DITORIAL(?:IZING)?|UPHEMISM)|S(?:A(?:ID|Y)|URVIVEDBY)|P(?:EA(?:COCK)?|UFFERY)|W(?:HATPLACE|EASEL)|R(?:ELTIME|ACIST)|CL(?:ICHE|AIM)|(?:MOSWT|AW)W|FLOWERY|VULGAR|IDIOM|LABEL|OPED)|ikipedia:Manual of Style/Words to watch))
Accessibility	Style	(?:\bW(?:ikipedia:Manual of Style/Accessibility|P:(?:ACCESSIBILITY|RESOL)))
Abbreviations	Style	(?:\bW(?:P:(?:ACRONYMTITLE|NCA(?:CRO)?|MOSABBR)|ikipedia:Manual of Style/Abbreviations))
Capital letters	Style	(?:\bW(?:P:(?:MOSC(?:APS|PT) |PROPERNAME|EXPABBR)|ikipedia:Manual of Style/Capital letters))
Pronunciation	Style	(?:\bW(?:ikipedia:Manual of Style/Pronunciation|P:MOSPRON))
Proper names	Style	(?:\bW(?:P:(?:MOSC(?:APS|PT) |PROPERNAME|EXPABBR)|ikipedia:Manual of Style/Capital letters))
Spelling	Style	(?:\bW(?:ikipedia:Manual of Style/Spelling|P:(?:SPELLING|MOSS|ISE)))
Text formatting	Style	(?:\bW(?:ikipedia:Manual of Style/Text formatting|P:MOSTEXT))
Titles	Style	(?:\bW(?:ikipedia:Manual of Style/Titles|P:MOST(?:ITLE)?))
Tables	Style	(?:\bW(?:ikipedia:Manual of Style/Tables|P:(?:WHENTABLE|HEADERS)))
Trivia sections	Style	(?:\bW(?:P:(?:MISC(?:ELLAN(?:EA|Y))?|TRIV(?:IA)?)|ikipedia:Manual of Style/Trivia sections))
Images	Style	(?:\bW(?:ikipedia:Manual of Style/Images|P:FIDUCIAL))
Captions	Style	(?:\bW(?:P:(?:CAP(?:CONTEXT|LENGTH|FRAG|TION|WORD)?|MAPOF)|ikipedia:Manual of Style/Captions))
Icons	Style	(?:\bW(?:P:(?:I(?:C(?:ONDECORATI)?ON|NFOBOXFLAG)|FLAG(?:PLACEHOLDER|CRUFT|BIO)|(?:APPROPRIATE|NO)ICONS|S(?:OVEREIGN|PORT)FLAG|MOS(?:FLAG|ICON|LOGO)|WORDPRECEDENCE|TOOMANY)|ikipedia:Manual of Style/Icons))
Lists	Style	(?:\bW(?:P:(?:(?:(?:(?:SOURC|DAT)E|FLAT|PURP|UB)LIS|BULLE(?:TLIS)?)T|L(?:EADFORALIST|ISTPURP)|CHRONO)|ikipedia:Manual of Style/Lists))
Embedded lists	Style	(?:\bW(?:P:(?:(?:(?:(?:SOURC|DAT)E|FLAT|PURP|UB)LIS|BULLE(?:TLIS)?)T|L(?:EADFORALIST|ISTPURP)|CHRONO)|ikipedia:Manual of Style/Lists))
Lists of works	Style	(?:\bW(?:P:(?:BIBLIOGRAPH(?:IES|Y)|MOS-BIBLIO|WORKS|LOW)|ikipedia:Manual of Style/Lists of works))
Road junction lists	Style	(?:\bW(?:ikipedia:Manual of Style/Road junction lists|P:RJL))
Stand-alone lists	Style	(?:\bW(?:P:(?:L(?:IST(?:C(?:RITERIA|OMPANY)|(?:GLOSSAR|VERIF)Y|(?:PEOPL|NAM)E|S?OFLISTS)|SC)|S(?:AL(?:ORDER|LEAD|AT)?|TAND(?:ALONE)?)|NC(?:LIST|SAL)|EXEMPT1E|CSC)|ikipedia:Stand-alone lists))
Biographies	Style	(?:\bW(?:ikipedia:Manual of Style/Biography|P:MOSBIO))
Article message boxes	Style	(?:\bWikipedia:Manual of Style/Article message boxes)
Disambiguation pages	Style	(?:\bW(?:ikipedia:Manual of Style/Disambiguation pages|P:MOSDAB))
Infoboxes	Style	(?:\bW(?:P:I(?:NFOBOX(?:ETH(?:NICITY)?|(?:IMAG|CIT)E|GEO|REF)|BI)|ikipedia:Manual of Style/Infoboxes))
Self-references to avoid	Style	(?:\bW(?:ikipedia:Manual of Style/Self-references to avoid|P:(?:S(?:UBJECT|ELF|RTA)|CLICKHERE|ITSELF|WAWI)))
Anime- and manga-related articles	Style	(?:\bW(?:ikipedia:Manual of Style/Anime- and manga-related articles|P:MOS-AM))
Comics	Style	(?:\bW(?:P:(?:C(?:MOS(?:#(?:S(?:TRUCTURE(?:-(?:(?:FICTIONALOBJ|SECTIONTITLE|CHARACTER|TEAM)S|PUBLICATION))?|PECIFIC|OURCES)|L(?:S(?:(?:PLI|OR)T|ECTION)|ISTS|NAME|F)|(?:C(?:IT(?:ESTYL)?|ATNAM|O)|BOXIMAG)E|P(?:RECISE|LOT|OP)|I(?:NFOBOX|SH)|N(?:ESTED|AME)|T(?:ITLES|EAM)))?|OMICS?PLOT)|OHOTMU)|ikipedia:Manual of Style/Comics))
Film	Style	(?:\bW(?:P:(?:FILM(?:(?:(?:C(?:RITICLI|A)|HI)S|PLO)T|M(?:ARKETING|USIC)|(?:RATIN|FLA)G|LE(?:AD|DE)|SC(?:ORE|I)|DIFF|YEAR|NFI)|(?:(?:(?:DEUTER|ANT)AGON|CASTL)IS|P(?:ROTAGONIS|LOTBLOA))T|T(?:R(?:ITAGONIST|AILER)|AGLINE)|MO(?:VIEPLOTS|SFILM)|YEARSINFILM)|ikipedia:Manual of Style/Film))
Lyrics and poetry	Style	(?:\bW(?:ikipedia:Lyrics and poetry|P:LYRICS))
Novels	Style	(?:\bW(?:P:(?:NOV(?:ELPLOT|STY)|MOS-NOVELS)|ikipedia:Manual of Style/Novels))
Philosophy	Style	(?:\bW(?:ikipedia:Manual of Style/Philosophy|P:PHILMOS))
Television	Style	(?:\bW(?:ikipedia:Manual of Style/Television|P:MOSTV))
Visual arts	Style	(?:\bW(?:ikipedia:Manual of Style/Visual arts|P:VAMOS))
Writing about fiction	Style	(?:\bW(?:ikipedia:Manual of Style/Writing about fiction|P:(?:BOOKPLOT|UNIVERSE)))
Music	Style	(?:\bW(?:P:M(?:OS(?:MUSIC(?:CAPS)?|SOPHOMORE|LYRICS)|USORG)|ikipedia:Manual of Style/Music))
Music samples	Style	(?:\bW(?:ikipedia:Manual of Style/Music samples|P:SAMPLE))
Record charts	Style	(?:\bW(?:ikipedia:Manual of Style/Record charts|P:MUSIC/(?:CHARTS|TABLE)))
Stringed instrument tunings	Style	(?:\bW(?:ikipedia:Manual of Style/Stringed instrument tunings|P:MOSTUNINGS))
Legal	Style	(?:\bW(?:ikipedia:Manual of Style/Legal|P:L(?:EGAL|AW)MOS))
Trademarks	Style	(?:\bW(?:ikipedia:Manual of Style/Trademarks|P:MOSTM))
Canada	Style	(?:\bW(?:P:(?:CAN(?:P(?:O[LP]|LACE|RIVY)|FRENCH|STYLE|CAN)|(?:THEYUKO|MOSCA)N)|ikipedia:Manual of Style/Canada-related articles))
China	Style	(?:\bW(?:ikipedia:Manual of Style/China and Chinese-related articles|P:(?:N(?:OCHINESEITALICS|C-CN)|CHINESECHARACTERS|PINYIN)))
France	Style	(?:\bW(?:ikipedia:Manual of Style/France and French-related articles|P:(?:FRENCHNAMES|MOSFR)))
Hawaii	Style	(?:\bW(?:ikipedia:Manual of Style/Hawaii-related articles|P:MOSHAWAII))
India	Style	(?:\bW(?:ikipedia:Manual of Style/India-related articles|P:(?:INDICSCRIPTS?|NOINDICSCRIPT|MOSI[NS])))
Ireland	Style	(?:\bW(?:P:(?:I(?:R(?:ISH FLAGS|E-IRL)|MO(?:S FLAG)?S)|(?:L(?:ONDON)?)?DERRY)|ikipedia:Manual of Style/Ireland-related articles))
Japan	Style	(?:\bW(?:ikipedia:Manual of Style/Japan-related articles|P:(?:J(?:A?TITL|PPLAC)E|M(?:OS-JA|J)|ROMAJI)))
Korea	Style	(?:\bW(?:ikipedia:Manual of Style/Korea-related articles|P:MOS(?:KOREA|-KO)))
Philippines	Style	(?:\bW(?:ikipedia:Manual of Style/Philippine-related articles|P:MOSPHIL))
Poland	Style	(?:\bW(?:ikipedia:Manual of Style/Poland-related articles|P:MOSPOL))
Singapore	Style	(?:\bW(?:ikipedia:Manual of Style/Singapore-related articles|P:MOS(?:DATESGP|SG)))
Trinidad and Tobago	Style	(?:\bW(?:ikipedia:Trinidad and Tobago Wikipedians|P:TTS(?:TYLE|G)))
Islam-related articles	Style	(?:\bW(?:ikipedia:Manual of Style/Islam-related articles|P:MOSISLAM))
Latter Day Saints	Style	(?:\bW(?:ikipedia:Manual of Style/Latter Day Saints|P:(?:LDS(?:JARGON|MOS)|MORMON)))
WikiProject Computer science	Style	(?:\bWikipedia:WikiProject Computer science/Manual of style)
Computing	Style	(?:\bW(?:ikipedia:Manual of Style/Computing|P:(?:COMPNOW|MOSCOMM)))
Chemistry	Style	(?:\bW(?:ikipedia:Manual of Style/Chemistry|P:(?:(?:MOS|N)CHEM|CHEMMOS)))
Mathematics	Style	(?:\bW(?:ikipedia:Manual of Style/Mathematics|P:(?:MSM|⋅)))
Medicine-related articles	Style	(?:\bW(?:P:(?:M(?:ED(?:(?:SECTION|MO)S|C(?:ASE|OPY)|LE(?:AD|DE)|TRIVIA|ORDER|PRICE|REF)|OSMED)|(?:CITE|NC)MED)|ikipedia:Manual of Style/Medicine-related articles))
Taxobox template	Style	(?:\bWP:T(?:AXO(?:BOX)?|X))
Cue sports	Style	(?:\bW(?:ikipedia:Manual of Style/Cue sports|P:(?:CUEMOS|MOSCUE)))
Snooker	Style	(?:\bW(?:P:(?:SNOOKER/(?:MOS|NF)|LIVESCORES|MOSSNOOKER)|ikipedia:Manual of Style/Snooker))
Wikipedia:Scientific citation guidelines	See also	(?:\bW(?:ikipedia:Scientific citation guidelines|P:SC(?:ICITE|G)))
Wikipedia:Artist's impressions of astronomical objects	See also	(?:\bW(?:P:(?:ASTR|EX)OART|ikipedia:Artist))
Wikipedia:In the news/Recurring items	See also	(?:\bW(?:ikipedia:In the news/Recurring items|P:ITN(?:(?:AWARD|SPORT)S|R)))
Wikipedia:Identifying reliable sources (medicine)	See also	(?:\bW(?:P:(?:M(?:ED(?:A(?:NIMAL|SSESS)|S(?:EARCH|CI)|B(?:IAS|OOK)|D(?:ATE|EF)|P(?:OP|RI)|R(?:EV|S)|INDY|COI|ORG)|BIAS)|(?:(?:DONTSHOUT|FUTON)BIA|HEALTHR)S|NO(?:TONLYFREE|ABSTRACT)|RSMED)|ikipedia:Identifying reliable sources (medicine)))
Wikipedia:Indic transliteration	See also	(?:\bWikipedia:Indic transliteration)
Wikipedia:Non-free use rationale guideline	See also	(?:\bW(?:ikipedia:Non-free use rationale guideline|P:(?:FU(?:RG?|G )|NFURG|RAT)))
Wikipedia:Public domain	See also	(?:\bW(?:P:(?:C(?:rown(?: copy(?:right)?|copy)|OPYEXP)|PD)|ikipedia:Public domain))
Wikipedia:WikiProject Economics/Reliable sources and weight	See also	(?:\bW(?:ikipedia:WikiProject Economics/Reliable sources and weight|P:ECON(?:/RS|RSW)))
Wikipedia:Shortcut	See also	(?:\bW(?:P:(?:S(?:C(?:JARGON|NAMES)?|HORT)|LINKBOXES|CHANGESC)|ikipedia:Shortcut))
Wikipedia:Project namespace	See also	(?:\bW(?:P:(?:P(?:R(?:J(?:C(?:RE)?|DEL|SD)?|O(?:CE)?PAGES)|(?:OLICYP)?AGES)|(?:H(?:OWTO|IS)|ESSAY|MAINT|INFO|DIS)PAGES|SUPPLEMENTAL|NS4)|ikipedia:Project namespace))
Wikipedia:Reference desk/Guidelines/Medical advice	See also	(?:\bW(?:ikipedia:Reference desk/Guidelines/Medical advice|P:RD/G/M))
Wikipedia:Talk page templates	See also	(?:\bWikipedia:Talk page templates)
Wikipedia:Userboxes	See also	(?:\bW(?:P:(?:U(?:SERBOX(?:C(?:REATE|AT))?|B(?:X(?:CREATE|NS)?|CR))|CREATEU(?:SERBO|B)X)|ikipedia:Userboxes))
Wikipedia:Template namespace	See also	(?:\bW(?:P:(?:T(?:(?:MP)?G|PN)|NS10)|ikipedia:Template namespace))
Wikipedia:Miscellany for deletion/Speedy redirect	See also	(?:\bW(?:ikipedia:Miscellany for deletion/Speedy redirect|P:(?:MFD/SRE?|SRE)))
Wikipedia:As of	See also	(?:\bW(?:P:(?:PRECISELANG|A(?:SOF|O))|ikipedia:As of))
Wikipedia:Extended image syntax	See also	(?:\bW(?:ikipedia:Extended image syntax|P:(?:PICSIZE|EIS)))
Wikipedia:Disambiguation/PrimaryTopicDefinition	See also	(?:\bWikipedia:Disambiguation/PrimaryTopicDefinition)
Wikipedia:Overcategorization/User categories	See also	(?:\bW(?:ikipedia:Overcategorization/User categories|P:(?:USERCAT(?:YES|NO)|OC/U)))
Wikipedia:Spellchecking	See also	(?:\bW(?:ikipedia:Spellchecking|P:SPELL(?:CHECK)?))
Wikipedia:TemplateStyles	See also	(?:\bWikipedia:TemplateStyles)
Wikipedia:Template namespace	See also	(?:\bW(?:P:(?:T(?:(?:MP)?G|PN)|NS10)|ikipedia:Template namespace))
Wikipedia:Wikimedia sister projects	See also	(?:\bW(?:P:(?:S(?:IS(?:TER|P)?|OFTSISP)|MOSSIS)|ikipedia:Wikimedia sister projects))
Wikipedia:WikiProject Council/Guide	See also	(?:\bW(?:P:(?:PROJ(?:GUIDE(?:#OWN)?|(?:SCOP|PAG)E)|(?:ADVICEPAG|REVIV)E|INACTIVEWP|COUNCIL/G|SCOPEWAR)|ikipedia:WikiProject Council/Guide))
Wikipedia:Manual of Style/Hidden text	See also	(?:\bW(?:ikipedia:Manual of Style/Hidden text|P:(?:INVISIBLE|HIDDEN)))
Wikipedia:Manual of Style/Military history	See also	(?:\bW(?:P:(?:MIL(?:MOS(?:#(?:C(?:O(?:DE(?:STYL|NAM)E|NFLICTS)|A(?:MPAIGNS|TNAME)|IT(?:ESTYL)?E)|B(?:A(?:TTLES(?:IN)?|SENAME)|PROJ)|N(?:A(?:V(?:PROBLEMS)?|ME)|ESTED)|S(?:PECIFIC|ECTLEN|OURCES)|(?:OPCAT|FLAG|TANK|WAR)S|IN(?:TERSECTION|FOBOX)|(?:DATERANG|PRECIS)E|UNIT(?:NAME|S)|APP))?|(?:(?:CI|DA)T|NAM)E|S(?:OURCE|G)|APP)|SHIPPRONOUNS|CAMPAIGN)|ikipedia:Manual of Style/Military history))
Wikipedia:Manual of Style/Indonesia-related articles	See also	(?:\bW(?:ikipedia:Manual of Style/Indonesia-related articles|P:ID-(?:N(?:AME|C)|SPELLING)))
Wikipedia:Manual of Style/Pakistan-related articles	See also	(?:\bW(?:ikipedia:Manual of Style/Pakistan-related articles|P:(?:URDUSCRIPT|NASTALIQ|MOSPA?K)))
Wikipedia:Manual of Style/Blazon	See also	(?:\bW(?:ikipedia:Manual of Style/Blazon|P:BL(?:AZON|Z)))
Wikipedia:Edit filter	See also	(?:\bW(?:P:(?:EF(?:M(?:AILING)?)?|(?:PRIVATE)?FILTER|AF)|ikipedia:Edit filter))
Wikipedia:Naming conventions (US stations)	See also	(?:\bW(?:ikipedia:Naming conventions (US stations)|P:USSTATION))
Wikipedia:Naming conventions (Irish stations)	See also	(?:\bW(?:ikipedia:Naming conventions (Irish stations)|P:IRLSTATION))
Wikipedia:Naming conventions (Canadian stations)	See also	(?:\bW(?:ikipedia:Naming conventions (Canadian stations)|P:CANSTATION))
Wikipedia:Naming conventions (places in Bangladesh)	See also	(?:\bW(?:ikipedia:Naming conventions (places in Bangladesh)|P:BDPLACE))
Wikipedia:Naming conventions (Football in Australia)	See also	(?:\bW(?:ikipedia:Naming conventions (Football in Australia)|P:(?:MOSFI|NCFI?)A))
Wikipedia:Five Pillars	See also	(?:\b(?:W(?:ikipedia:Five Pillars|P:(?:PILLARS|5P))|w.wiki/5))
